aixcd	MzbdON MzbeON MzbaON MzbeOFF MzbaOFF MzakON MzbaON MzbdOFF MzaiON MzbaOFF MzahON MzaiOFF MzakOFF MzagON MzaeON MzahOFF MzadON MzagOFF MzadON MzadOFF MzziON MzzkON MzaeOFF MzziOFF MzzkOFF MzziON MzzkON MzziOFF	
aixce	MzzkOFF MzaeON MzagON MzahON MzaeOFF MzagOFF MzahOFF MzahON MzahOFF MzahON	
aixcg	MzahOFF MzahON MzahOFF MzahON MzahOFF	
aixch	MzahON MzagON MzaeON MzagOFF MzahOFF MzaeON MzaeOFF MzaeON MzagON MzaeOFF MzahON MzagOFF MzahOFF
aixci	MzahON MzahOFF MzahON MzaiON MzaiOFF MzahOFF MzaiON MzahON MzaiOFF MzahOFF MzahON MzahOFF MzahON MzahOFF MzahON MzahON MzahOFF	
aixck	MzahOFF MzahON MzahON MzahOFF MzahON MzahOFF MzahON MzahOFF MzahON MzagON MzaeON MzzkON MzziON MzzhON MzahOFF MzzgON MzaeON MzagOFF MzzeON MzzkOFF MzaeOFF MzzhOFF MzziOFF MzzgOFF MzzeOFF	
aixdz	MzzgON MzzeON MzzgOFF MzzeOFF MzzeON MzzeOFF MzzeON MzzeOFF	
aixda	MzzeON MzzeOFF	
aixdb	MzzeON MzzgON MzzgOFF MzzgON MzzgOFF MzzeOFF MzzeON MzzgON MzzgOFF MzzeOFF MzzeON MzzgON MzzgON MzzgOFF MzzeOFF MzzeON MzzeOFF MzzeON MzzeOFF MzzeON MzzeOFF MzzeON MzzgON MzzeOFF MzzgOFF
aixdc	MzzeON MzzeON MzzeOFF MzzeOFF MzzeON MzzgON MzzgOFF MzzeOFF MzzeON MzzeOFF MzzeON MzzeOFF MzzeON MzzeOFF MzzeON MzzeOFF	
aixdd	MzzeON MzzeOFF MzzeON MzzgON MzzgOFF MzzeOFF MzzeON MzzeOFF MzzeON MzzeOFF MzzeON MzzeOFF
aixde	MzzeON MzzeOFF MzzeON MzzeON MzzeOFF MzzeON MzzeOFF MzzeON MzzeOFF MzzeON MzzeOFF MzzeON MzzeON MzzeOFF	
aixdg	MzzeON MzzeOFF MzzeON MzzeOFF MzzeON MzzeOFF MzzeON MzzeON MzzeOFF	
aixdh	MzzeON MzzeOFF MzzeON MzzeOFF MzzeON MzzeOFF MzzeON MzzeOFF
aixdi	MzzeON MzzeOFF MzzeON MzzeOFF MzzeON MzzeOFF MzzeON MzzeOFF MzzeON MzzeOFF MzzeON MzzeOFF MzzeON MzzeOFF MzzeON MzzeOFF
aixdk	MzzeON MzzeOFF MzzeON MzzeOFF MzzeON MzzeOFF MzzeON MzzeOFF MzzeON MzzeOFF	
aixez	MzzeON MzzeOFF MzzeON MzzeOFF MzzeON MzzgON MzzeOFF MzzgOFF MzzgON MzzgOFF MzzeON	
aixea	MzzgON MzzeOFF MzzgOFF MzzgON MzzeON MzzgOFF MzzeOFF MzzeON MzzeOFF MzzeON MzzeOFF MzzeON
aixeb	MzzgON MzzgOFF MzzeOFF MzzeON MzzeOFF MzzeON MzzgON MzzeOFF MzzgOFF MzzeON MzzeOFF MzzeON MzzeOFF MzzeON MzzeOFF MzzeON MzzeOFF MzzeON MzzgON MzzeOFF MzzeON MzzgOFF MzzeOFF	
aixec	MzzeON MzzeOFF MzzeON MzzeOFF	
aixed	MzzeON MzzeOFF MzzeON MzzeON MzzeOFF MzzeOFF	
aixeg	MzzeON MzzeOFF	
aixeh	MzzgON MzzeON MzzgOFF MzzeOFF MzzeON MzzeOFF MzzeON MzzeOFF	
aixei	MzzeON MzzeOFF MzzeON MzzeOFF MzzeON MzzeOFF	
aixek	MzzeON MzzeOFF MzzeON MzzgON MzzgOFF MzzeOFF MzzeON MzzeOFF MzzeON MzzeOFF MzzeON MzzeOFF MzzeON MzzeOFF	
akxzz	MzzgON MzzeON MzzhON MzziON MzzkON MzzeOFF MzaeON MzagON MzzkOFF MzzhOFF MzzgOFF MzziOFF MzaeOFF MzaeON MzzkON MzziON MzagOFF MzaeOFF MzziOFF MzziON MzziOFF MzziON MzziON MzzhON MzzgON MzzkOFF MzziOFF MzzhOFF MzzgOFF MzzgON MzzeON MzzgOFF MzzeOFF
akxza	MzzeON MzzgON MzzgOFF MzzeOFF MzzeON MzzeOFF MzzeON MzzeOFF MzzeON MzzeOFF MzzeON MzzeOFF MzzgON MzzgOFF MzzeON MzzgON MzzgOFF MzzgON MzzeOFF MzzeON MzzeOFF MzzgOFF	
akxzb	MzzeON MzzeOFF MzzeON MzzeOFF	
akxzc	MzzeON MzzeOFF MzzeON MzzeON MzzeOFF MzzeON MzzgON MzzeOFF MzzeON MzzgOFF MzzgON MzzeOFF MzzgOFF MzzeON MzzeOFF	
akxzd	MzzeON MzzeOFF MzzeON MzzeOFF	
akxze	MzzeON MzzeOFF MzzeON MzzeOFF MzzgON MzzgOFF MzzeON MzzeOFF	
akxzg	MzzeON MzzeOFF MzzgON MzzeON MzzgOFF MzzeOFF MzzeON MzzgON MzzgOFF MzzeOFF	
akxzh	MzzeON MzzeON MzzeOFF MzzeON MzzeOFF	
akxag	MzzgON MzzgOFF	
akxbz	MzzgON MzzgOFF MzaaON MzzgON MzaaOFF MzzgOFF	
akxbc	MzaaON MzzgON MzzeON MzaaOFF MzzgOFF MzzeOFF MzaaON MzaaOFF MzaaON MzaaOFF	
akxbd	MzaaON MzzeON MzzgON MzzeOFF MzzgOFF MzzgON MzazON MzaaOFF MzazOFF MzzgON MzzgOFF MzzgOFF	
akxbe	MzzeON MzzgON MzzeOFF MzzgOFF MzzgON MzaaON MzazON MzzeON MzzeOFF MzaaOFF MzazOFF MzzgOFF MzaaON MzzgON MzzeON MzzgOFF MzaaOFF MzzeOFF	
akxbg	MzaaON MzzgON MzazON MzzeON MzazOFF MzaaOFF MzzeOFF MzzgOFF	
akxbi	MzaaON MzzgON MzzeON MzzgOFF
akxbk	MzzeON MzzeOFF MzzgON MzzgOFF MzaaOFF MzaaON MzaaOFF MzaaON MzzgON MzaaOFF MzzgOFF	
akxcz	MzaaON MzaaOFF	
akxca	MzaaON MzaaOFF MzzgON MzaaON MzazON MzaaOFF MzzeON MzazOFF MzzeOFF MzzgOFF MzzgON MzzgON MzzgOFF MzaaON MzzgON MzzgOFF MzzgON MzaaOFF MzzgOFF MzzgON	
akxcb	MzzgOFF MzzgON MzzgOFF MzzgON MzzgOFF	
akxcc	MzzgON MzzeON MzaaON MzazON MzzeOFF MzzgOFF MzazOFF MzaaOFF MzazON MzzgON MzaaON MzazOFF MzzgOFF MzaaOFF MzaaON MzzgON MzaaOFF MzzgOFF	
akxcd	MzzgON MzaaON MzaaOFF MzzgOFF	
akxch	MzaaON MzzgON MzzeON MzaaOFF MzzeON MzzhON MzzeOFF MzziON MzzkON MzaeON MzagON MzzkOFF MzzhOFF MzzgOFF MzziOFF MzagOFF MzaeOFF MzahON MzagON MzagOFF MzahOFF MzagON MzahON MzaeON MzziON MzzkON MzzhON MzzgON MzagOFF MzzkOFF MzaeOFF MzahOFF MzaaON MzzhOFF MzziOFF MzzgOFF MzaaOFF
akxci	MzzgON MzzgOFF MzaaON MzaaOFF MzaaON	
akxck	MzaaOFF MzzgON MzzgOFF MzzgON MzzgOFF MzaaON MzzgON MzaaON MzzgOFF MzaaOFF MzaaON MzaaOFF MzaaON MzaaOFF	
akxdz	MzaaON MzaaOFF MzzgON MzzgOFF MzaaON MzaaOFF MzaaON MzaaOFF	
akxda	MzaaON MzaaOFF MzaaON MzzgON MzzeON MzzgON MzaaOFF MzzeOFF MzazON MzzgOFF MzaaON	
akxdb	MzazOFF MzaaOFF MzzgON MzaaON MzazON MzazOFF MzaaOFF MzzgON MzazON MzzgOFF MzaaON MzazOFF	
akxdc	MzaaOFF MzaaON MzaaOFF MzzeON MzaaON MzzeOFF MzaaOFF	
akxdd	MzaaON MzaaOFF
akxdg	MzaaON MzzgON
akxdh	MzaaOFF MzzgOFF MzaaON MzaaOFF MzaaON MzaaOFF MzaaON MzaaOFF MzaaON MzzgON MzaaOFF MzzgOFF MzzgON MzzgOFF MzzgON MzaaON MzaaOFF MzzgOFF	
akxdi	MzaaON MzzgON MzzgOFF MzaaOFF MzzgON MzzgOFF MzzgON MzzgOFF	
akxdk	MzaaON MzaaOFF MzaaON MzaaOFF MzaaON MzaaOFF MzaaON MzazON MzaaOFF MzazOFF MzazON MzazOFF	
akxez	MzzgON MzzgOFF
akxeb	MzzgON MzaaON MzzgOFF MzaaOFF MzzgON MzzgOFF
akxec	MzzgON MzzgOFF	
akxed	MzaaON MzzgON MzaaON MzazON MzaaOFF MzzgOFF MzazOFF	
akxee	MzzgON MzzgOFF MzzgON MzzgOFF MzzgON MzaaON MzazON MzaaOFF MzazOFF MzzgOFF MzzgON MzzgOFF MzazON	
akxeg	MzazOFF MzzgON MzzgOFF MzazON MzazOFF	
akxeh	MzzgON MzzgOFF
akxei	MzzgON MzzgOFF MzzgON MzzgOFF
bzxzz	MzzgON MzzgOFF
bzxza	MzzgON MzzgOFF MzazON MzazOFF MzaaON MzzgON MzazON MzaaOFF MzazOFF MzzgON MzzgOFF MzaaON
bzxzb	MzaaOFF MzzgON MzzgOFF MzzgON MzzgOFF	
bzxzc	MzzgON MzaaON MzzgOFF MzaaOFF MzzgON MzaaON MzaaOFF MzaaON MzzgOFF MzaaOFF MzaaON MzaaOFF MzaaON MzaaOFF MzzgON MzazON MzzeON MzzhON MzazOFF MzzaON MzzeOFF MzbcON MzbbON MzzgOFF MzzhOFF MzzaOFF MzbcOFF MzbcON MzzaON MzzhON MzbcOFF MzbbOFF MzbbON
bzxzd	MzzaOFF MzbbOFF MzzaON MzbcON MzbbON MzzaOFF MzbcOFF MzzhOFF MzbaON MzbdON MzbeON MzbbOFF MzbgON MzbaOFF MzbdOFF MzbeOFF MzbhON MzbgOFF MzbiON MzbkON MzchON MzbhOFF MzbiOFF MzbkOFF MzchOFF
bzxad	MzchON MzbkON MzczON MzchOFF MzcgON MzcbON MzccON MzbkOFF MzcgOFF MzczOFF MzcbOFF MzccOFF MzccON MzcbON MzccOFF MzcaON MzcaOFF MzcgON MzcbOFF MzczON MzbkON MzbiON MzbhON MzcgOFF MzczOFF MzbkOFF MzbiOFF MzbhOFF MzbhON
bzxae	MzbgON MzbeON MzbhOFF MzbgOFF MzbdON MzbaON MzakON MzbeOFF MzbaOFF MzaiON MzbdOFF MzahON MzakOFF MzaiOFF MzahOFF MzahOFF MzahON MzahOFF MzahON MzahOFF	
bzxag	MzahON MzaeON MzagON MzziON MzzkON MzagOFF MzzhON MzahOFF MzzgON MzzkOFF MzaeOFF MzzeON MzzhOFF MzziOFF MzzeOFF MzzhON MzziON MzaeON MzagON MzzhOFF MzziOFF MzahON MzagOFF MzzgOFF MzaeOFF MzaiON MzahON MzaiOFF MzahOFF MzaiON MzahON MzahOFF MzaiOFF MzahON MzahOFF MzahON MzahOFF MzahON MzahOFF MzahON
bzxah	MzahOFF MzahON MzahON MzahOFF MzahON MzahOFF	
bzxai	MzaiON MzaiOFF MzaiON MzahON MzaiOFF MzahOFF MzahON MzaiON MzaiOFF MzahOFF MzahON MzaiON MzahOFF MzaiON MzahON MzaiOFF MzahOFF	
bzxak	MzaiON MzaiOFF MzahON MzagON MzaeON MzzkON MzahOFF	
bzxbz	MzagOFF MzaeOFF MzzkON MzziON MzzhON MzzgON MzziOFF MzzhOFF MzzkOFF MzzhON MzziON MzzkON MzzgOFF MzaeON MzzhOFF MzziOFF MzahON MzzkOFF MzaiON MzaeOFF MzahOFF MzahON MzaiOFF MzahOFF MzahON MzaiON MzahOFF MzahON MzaiOFF MzagON MzaeON MzahOFF MzagOFF MzziON MzzkON MzzhON	
bzxba	MzaeOFF MzzkOFF MzziOFF MzzhOFF MzzhON MzzkON MzzkOFF MzzhOFF MzzhON MzzhOFF MzzhON MzzhOFF MzzhON MzzhOFF MzziON MzziOFF MzzhON MzziON MzzhOFF MzziOFF MzzhON MzzkON MzzhOFF MzzkOFF MzzkON MzzhON MzzkOFF MzzhOFF	
bzxbb	MzzhON MzziON MzziOFF MzzhOFF MzzhON MzziON MzzhOFF MzziOFF MzaeON MzagON MzahON MzaeOFF MzaiON MzagOFF MzagON MzaeON MzadON MzaiOFF MzahOFF MzaeOFF MzacON MzagOFF MzadOFF MzadON MzaeON MzagON MzadOFF MzagOFF MzahON MzacOFF MzaeOFF MzaiON MzahOFF MzahON MzaiOFF MzahOFF MzagON MzagOFF
bzxbc	MzahON MzagON MzagOFF MzagON MzagOFF MzahOFF MzahON MzahOFF MzahON MzaiON MzakON MzbaON MzahOFF MzbdON MzaiOFF MzbeON MzakOFF MzbaOFF MzbeOFF MzbdOFF	
zcxbg	MzbdON MzbeON MzbeON MzbeOFF MzbdOFF MzbgON MzbeOFF MzbhON MzbgOFF MzbiON MzbkON MzczON MzcgON MzbiOFF MzbhOFF MzbkOFF MzcaON MzczOFF MzcgOFF MzcbON MzcbOFF MzcgON MzcaOFF MzcaON MzcgOFF MzcbON MzceON
zcxbh	MzcgON MzcgOFF MzcgON MzcbOFF MzcgON MzcgOFF MzcaOFF MzcaON MzcbON MzceOFF MzcgOFF MzcbOFF MzceON MzcbON MzceOFF MzcaOFF MzceON MzcbOFF MzcgON MzcgOFF MzcbON MzcgON MzcgOFF MzcgON MzcbOFF MzcgOFF MzcgON MzcgOFF MzceOFF MzcgON MzceON MzczON MzbkON MzceOFF MzcbON MzcaON MzczOFF MzccON MzbkOFF MzcaOFF MzcgOFF MzccOFF MzcbOFF
zcxbi	MzccON MzcbON MzcaON MzccOFF MzcbOFF MzcaOFF MzcaON MzcbON MzcdON MzceON MzcbOFF MzcaOFF MzceOFF MzceON MzceOFF MzceON MzceOFF MzceON MzccON MzccOFF MzccON MzceOFF MzceON MzccOFF MzceOFF MzceON MzcbON MzcbOFF MzceOFF MzceON MzceOFF MzcdOFF MzcdON MzceON MzccON MzcdOFF MzcdON
zcxbk	MzceOFF MzcdOFF MzccOFF MzccON MzcdON MzceON MzceOFF MzceON MzccOFF MzceOFF MzcdOFF MzceON MzceOFF MzceON MzceOFF MzceON MzceOFF	
zcxcz	MzceON MzceOFF MzceON MzceOFF MzceON MzceOFF MzceON MzceOFF MzceON
zcxca	MzceOFF MzceON MzcgON MzcgOFF MzcgON MzcgOFF MzceOFF MzceON MzceON MzceOFF MzceON MzceOFF	
zcxcc	MzceON MzceOFF
zcxce	MzceON MzceOFF MzceON MzceOFF
zcxch	MzceON MzceOFF MzceON MzcdON MzcdOFF MzceOFF	
zcxci	MzceON MzceOFF MzceON MzceOFF MzceON MzceOFF MzceON MzceOFF MzceON MzceOFF	
zcxdb	MzceON MzceOFF	
zcxdc	MzceON
zcxdd	MzceOFF
zcxdi	MzceON MzceOFF MzceON MzceOFF	
zcxdk	MzceON MzceOFF MzceON MzceOFF MzceON MzcdON MzceOFF MzcdOFF MzceON MzcdON MzceOFF MzcdOFF	
zcxez	MzceON MzceOFF	
zcxec	MzceON
zcxed	MzceOFF MzceON MzceOFF MzceON MzcdON MzcdOFF MzcdON MzcdOFF MzcdON MzceOFF MzcdOFF MzceON MzcdON MzcdOFF MzceOFF
zdxdd	MzceON MzceOFF MzceON MzceOFF	
zdxde	MzcdON MzceON MzcdOFF MzcdON MzceOFF MzceON MzcdOFF MzcdON MzceOFF MzcdOFF MzceON MzceOFF MzceON	
zdxdg	MzceOFF MzceON MzceOFF MzceON MzceON MzceOFF MzceON MzceOFF MzceON MzceOFF MzceON MzcdON MzcdOFF MzcdON
zdxdh	MzcdOFF MzceOFF MzceON MzcdON MzccON MzcbON MzcaON MzcgON MzcaOFF MzczON MzccOFF MzcdOFF MzcbOFF MzbkON MzceOFF MzchON MzcgOFF MzczOFF MzbkOFF MzchON MzchOFF
zdxdk	MzchON MzbkON MzczON MzcgON MzcaON MzcbON MzchOFF MzceON MzccON MzbkOFF MzczOFF MzcdON MzcaOFF MzcgOFF MzcbOFF MzccOFF MzcdOFF MzcdON MzcdOFF MzceOFF MzcdON MzceON MzcdOFF MzcdON MzcdOFF MzceOFF
zexcd	MzceON MzceOFF	
zexch	MzceON MzcdON MzcdOFF MzcdON MzcdOFF MzcdON MzcdOFF MzcdON MzcdOFF MzceOFF MzceON MzceOFF MzceON MzceOFF
zexek	MzceON MzcdON MzcdOFF MzceOFF MzcdON MzcdOFF MzcdON MzceON MzcdOFF MzceOFF MzceON
zgxzz	MzceOFF 
zgxza	MzcdON MzcdOFF
zgxzb	MzcdON MzceON MzcdOFF MzceOFF MzcdON MzceON MzceON MzcdOFF MzceOFF
zgxze	MzcdON MzcdOFF	
zgxzg	MzceON MzcdON MzcdOFF MzcdON MzceON MzcdOFF MzcdON MzceOFF MzceON MzcdOFF MzcdON MzceOFF MzcdOFF MzceON MzcdON MzcdOFF MzcdON MzceOFF MzcdOFF MzcdON MzcdOFF
zgxzh	MzceON MzcdON MzcdOFF MzceOFF MzceON MzceOFF MzceON MzcdON MzcdOFF MzcdON MzcdOFF MzcdON MzceOFF MzceON MzcdOFF	
zgxzi	MzceOFF
zgxba	MzceON MzceOFF	
zgxbi	MzceON
zgxbk	MzcdON MzceOFF MzcdOFF
zgxda	MzcdON MzceON MzcdOFF MzceOFF	
zgxdb	MzceON MzcdON MzcdOFF MzceOFF MzceON MzcdON MzcdOFF MzceOFF MzceON	
zgxdc	MzceOFF MzceON MzceOFF
zgxee	MzceON MzceOFF MzceON MzceOFF MzceON MzceOFF MzceON MzceOFF MzceON MzceOFF	
zgxeg	MzcdON MzceON MzcdON MzcdOFF MzcdON MzcdOFF MzceOFF MzceON MzcdON MzcdOFF MzceOFF MzceON MzcdON MzceOFF MzcdOFF	
zhxzb	MzceON MzcdON MzcdOFF MzceOFF
zhxzc	MzceON MzceOFF	
zhxcd	MzceON MzcdON MzcdOFF MzcdON MzccON MzccON	
zhxce	MzcbON MzcaON MzcbOFF MzcdOFF MzceOFF MzccOFF MzcaOFF MzcaON MzcaOFF MzcaON MzcbON MzceON MzccON MzcdON MzccOFF MzcaOFF MzcbOFF MzcdOFF MzceOFF	
zhxdb	MzceON MzcdON MzcdOFF MzcdON MzccON MzcbON MzccON MzccOFF MzcaON MzccOFF MzceOFF MzcbOFF MzcdOFF MzcaOFF MzcaON MzcbON MzceON MzccON MzcdON MzceOFF MzcdOFF MzcbOFF MzcaOFF MzccOFF MzccON MzcdON MzceON MzccOFF MzccON MzceOFF MzccOFF MzcdOFF MzcdON MzceON MzccON MzccOFF	
zhxdc	MzcdON MzcdOFF MzceON MzceOFF MzceON MzceOFF	
zhxdg	MzceON MzcdON MzcdOFF MzcdON MzcdOFF MzceOFF MzceON MzcdON MzceOFF MzcdOFF
zhxdk	MzceON MzcdON MzcdOFF MzcdON MzccON MzcbON MzcaON MzcdOFF MzcdON MzccON MzceOFF MzcdOFF MzcbOFF MzccON MzcaOFF MzccOFF MzccON MzcdON MzceON
zhxez	MzccOFF MzcdOFF MzceON MzceOFF MzceON MzceOFF MzceON	
zhxea	MzceOFF MzceON MzceOFF MzceON MzceOFF
zhxeg	MzceON MzcdON MzcdOFF MzcdON MzccON MzccOFF MzcbON MzcaON MzccON MzccOFF MzcbOFF MzcbON MzcdOFF MzceOFF MzceON MzccON MzcdON MzccOFF MzcbOFF MzcaOFF	
zhxeh	MzcdOFF MzceOFF	
zixzz	MzceON MzcdON MzcdOFF MzcdON MzcdOFF MzceOFF	
zixzb	MzceON MzcdON MzcdOFF MzcdON MzcdOFF MzcdON MzcdOFF MzceOFF	
zixzc	MzceON MzcdON MzcbON MzccON MzcaON MzccOFF MzcdOFF MzcbOFF MzceOFF MzcbON MzcbOFF
zixzd	MzcbON MzceON MzccON MzccOFF MzccON MzceOFF MzccOFF MzceON MzcaOFF MzccON MzcaON MzccOFF MzcgON MzcaOFF MzceOFF MzcaON MzcaOFF MzczON MzbkON MzchON MzcbOFF MzczOFF MzcgOFF MzchOFF MzchON MzbkOFF MzchON MzchOFF
zixac	MzchON MzbkON MzczON MzcgON MzcaON MzchOFF MzcbON MzczOFF MzbkOFF MzcgOFF
zixad	MzceON MzcaOFF MzceOFF MzceON MzcbOFF MzcbON MzcaON MzcaOFF MzceOFF MzcaON MzcaOFF MzcaON MzcaOFF MzcaON MzcaOFF MzceON MzceOFF MzceON MzcdON MzceOFF MzceON MzcbOFF MzceOFF MzceON	
zixae	MzceOFF MzccON MzceON MzccOFF MzceOFF MzccON MzceON MzccOFF MzceOFF MzceON MzceON MzceOFF MzceON MzcdOFF MzcdON MzccON MzceOFF MzceON MzccOFF MzcdOFF MzceOFF MzcdON MzcdOFF MzcdON MzcdOFF MzcdON MzcdOFF MzcdON MzceON MzccON MzceOFF MzceON MzccOFF MzceOFF MzceON MzcdOFF MzceOFF
zixag	MzceON MzcdON MzccON MzceOFF MzccOFF MzcdOFF MzccON MzcdON MzceON MzccOFF MzcbON MzcgON MzcbOFF MzczON MzbkON MzchON MzceOFF MzcdOFF MzcgOFF MzczOFF MzchOFF MzbkOFF
zixah	MzchON MzbkON MzczON MzcgON MzbkOFF MzchOFF MzczOFF MzcbON MzceON MzccON MzcdON MzccOFF MzcdOFF MzcbOFF MzcgOFF MzcdON MzcdOFF MzcdON MzceOFF MzcdOFF MzceON MzcdON MzcdOFF MzceOFF MzceON MzcdON MzcdON MzcdOFF MzcdOFF
zixai	MzceON MzceOFF MzceON MzceOFF MzceON MzceOFF MzceON MzceOFF MzceON MzceOFF
zixak	MzceON MzccON MzceOFF MzceON MzccOFF MzcbON MzcgON MzcbOFF MzcgON MzcaON MzceOFF MzcgOFF MzcaOFF MzcaON MzcbON MzcgON MzcgOFF MzcbON MzcgON MzceON MzcbOFF MzcgOFF MzceOFF MzcgON MzceON MzcaOFF MzcbON MzcgOFF MzceOFF MzcbOFF	
zixbz	MzcbON MzcbON MzcbOFF MzcbOFF MzcbON MzcbOFF MzcbON MzcbOFF MzcbON MzcbON MzcbOFF MzcbON MzcaON MzcbOFF MzcbON MzceON MzcdON MzcbOFF MzcbON MzcaOFF MzcbOFF MzcbON MzcgON MzcaON MzcdOFF MzcgOFF MzcbOFF MzceOFF MzcbON MzcbOFF MzcbON MzcaOFF MzcaON MzcbOFF MzcbON MzcgON MzcaOFF MzczON MzcbOFF MzbkON MzcgOFF MzbiON
zixba	MzczOFF MzbhON MzbkOFF MzbiOFF MzbhOFF MzbgON MzbeON MzbgOFF MzbdON MzbaON MzbeOFF MzbdOFF MzbbON MzbaOFF MzbcON MzzaON MzzhON MzbbOFF MzzaOFF MzzgON MzbcOFF MzzkON MzazON MzzkOFF MzzhOFF MzzgOFF MzzgON MzzeON MzazOFF MzzeOFF MzzeON MzzeOFF MzzgON MzzgOFF MzzhON MzzgOFF
zixbb	MzzaON MzbcON MzzhOFF MzbbON MzzaOFF MzbaON MzbcOFF MzbbOFF MzbaOFF MzbaON MzbdON MzbaOFF MzbdON MzbdOFF	
aexzb	MzzeON MzazON MzzgON MzzeOFF MzzeON MzzeOFF MzzgOFF MzazOFF MzzgON MzzgOFF MzzgON MzzeON	
aexzc	MzzhON MzzeOFF MzzkON MzziON MzaeON MzagON MzziOFF MzahON MzzkOFF MzzhOFF MzzgOFF MzaeOFF MzagOFF MzahOFF MzahON MzahOFF MzahON MzahOFF MzahON MzahOFF MzahON MzahOFF MzahON	
aexzd	MzahOFF MzahON MzagON MzaeON MzahOFF MzzkON MzziON MzzhON MzagOFF MzzgON MzaeOFF MzzkOFF MzzgON MzziOFF MzzhOFF MzazON MzzkON MzzgOFF MzzkOFF MzazON MzazOFF MzzgON MzzgOFF MzazOFF MzzkON MzzhON MzziON MzzkOFF MzzhOFF MzziOFF MzziON MzziOFF MzziON MzziON MzziOFF MzziON MzzhON	
aexze	MzzgON MzazON MzzhOFF MzazOFF MzzgOFF MzziOFF MzazON MzazOFF MzazON MzazOFF
aexzh	MzzgON MzzeON MzazON MzzeON MzzeOFF MzazOFF
aexzi	MzzeOFF MzzgOFF MzzgON MzzhON MzziON MzzkON MzaeON MzagON MzziOFF MzzhOFF MzahON MzzgOFF MzahOFF MzaeOFF MzahON MzagOFF MzagON MzaeON MzziON MzzkON MzahOFF MzzhON MzzgON MzaeOFF MzagOFF MzzkOFF MzzhOFF MzziOFF MzazON MzazOFF MzazON MzzgOFF MzzgON MzazOFF MzazON MzzgOFF MzazOFF MzazON
aexzk	MzazOFF MzazON MzazOFF MzazON MzazOFF MzazON MzzgON MzzeON MzazOFF MzzeOFF MzzgOFF MzzgON MzazON MzzgOFF MzazOFF MzazON MzzgON MzzeON MzazOFF MzzgON MzzeON MzzeOFF MzzgOFF MzazON MzazON MzazOFF MzazON MzazOFF MzazON
aexaz	MzazOFF MzazON MzazOFF MzazON MzazOFF
aexae	MzazON MzazOFF	
aexag	MzzgON MzazON MzzgOFF MzazOFF MzazON MzazOFF MzzgON
aexah	MzzgOFF MzzgON MzzgOFF MzazON MzazOFF MzazON MzazOFF MzzgON MzzgOFF MzazON MzazOFF	
aexai	MzazON MzazOFF	
aexak	MzazON MzazOFF
aexba	MzzgON MzzgOFF MzzgON MzzgOFF MzazON MzazOFF MzazON MzazOFF MzazON MzazOFF
aexbb	MzazON MzazOFF
aexbd	MzazON MzazOFF
aexbe	MzzgON MzzgOFF MzzgON MzzgOFF MzzgON MzzgOFF MzzgON MzzgOFF	
aexbg	MzazON MzazOFF MzazON MzazOFF MzzgON MzzgOFF	
aexcz	MzazON MzzkON	
aexca	MzzkOFF MzazOFF MzazON MzazOFF
aexcd	MzazON MzazOFF
aexdb	MzzhON MzazON MzzgON MzazOFF
aexdc	MzzhOFF MzzeON MzzgOFF MzzeOFF MzzgON MzzeON MzzgOFF MzzgON MzzeOFF MzzeON MzzeOFF MzzgOFF MzzgON MzzgOFF MzzgON MzzgOFF MzazON MzzgON MzazOFF	
aexdd	MzzgOFF MzzgON MzzeON MzzgOFF MzzeOFF
aexde	MzzgON MzzeON MzzeOFF MzzeON MzazON MzazON MzzeOFF MzzgOFF MzazOFF MzzgON MzzgOFF	
aexdh	MzzgON MzazON MzazOFF MzzgOFF MzzeON MzzeOFF MzzgON MzzhON MzziON MzzgOFF MzzkON MzaeON MzagON MzzhOFF MzzkOFF MzziOFF MzahON MzagOFF MzaeOFF MzahOFF MzahON MzagON MzaeON MzziON MzzkON MzzhON MzagOFF MzahOFF MzzgON MzaeOFF MzzkOFF MzziOFF MzzhOFF MzzgOFF MzzgON MzzgOFF	
aexdi	MzzgON MzzgOFF MzazON MzazOFF MzazON MzazOFF MzzgON MzzgOFF	
aexeh	MzzgON MzzgOFF MzazON MzazOFF MzazON MzazOFF MzazON MzazOFF MzazON MzazOFF MzazON MzazOFF
aexei	MzzgON MzzgOFF MzzgON MzzgOFF MzzgON MzzgOFF MzzgON MzzgOFF	
agxzc	MzzgON MzzgOFF	
agxze	MzazON MzazOFF	
agxzh	MzazON MzazOFF	
agxaa	MzazON MzazOFF MzzeON MzzeOFF	
agxac	MzazON MzazOFF MzazON MzzgON MzazOFF MzzhON MzziON MzzaON MzbcON MzzgOFF MzziOFF MzziON MzbbON MzbaON MzzhOFF MzziOFF MzbcOFF MzbeON MzbdON MzzaOFF MzbgON MzbbOFF MzbhON MzbaOFF MzbdOFF MzbeOFF MzbiON MzbgOFF MzbkON MzchON MzbhOFF MzbiOFF MzbkOFF
agxad	MzchOFF
agxbe	MzchON MzchOFF MzchON MzbkON MzbkOFF MzbkON MzczON MzchOFF MzbiON MzbhON MzczOFF MzbgON MzbhOFF MzbkOFF MzbiOFF MzbeON MzbgOFF MzbdON MzbaON MzbeOFF MzbbON MzbdOFF MzbcON MzzaON MzbaOFF MzbbOFF MzzhON MzbcOFF MzzhOFF MzzaOFF MzzhON
agxbg	MzzbON MzzcON MzzhOFF MzzbOFF MzzbON MzzgON MzzhON MzzbOFF MzzcOFF MzzgON MzzhOFF MzzgOFF MzzhON MzzgON MzziON MzzgOFF MzzhOFF MzziOFF MzziON MzzhON MzzhOFF MzziOFF MzzhON MzziON MzzaON MzziOFF MzzaOFF
agxbh	MzzhOFF MzzaON MzzaOFF MzzhON MzziON MzzhOFF MzzkON MzziOFF MzzkOFF MzzkON MzziON MzzhON MzzhOFF MzzkOFF MzziOFF MzzhON MzzaON MzbcON MzzhOFF MzbbON MzbaON MzzaOFF MzbcOFF MzbdON MzbbOFF MzbeON MzbaOFF MzbdOFF MzbdON MzbeOFF MzbdON MzbdOFF
aixcd	MzbdON MzbdOFF MzbdON MzbaON MzbdOFF MzbbON MzbaOFF MzbcON MzbbOFF MzzaON MzzaON MzzaOFF	
aixce	MzzhON MzbcOFF MzzaOFF MzzgON MzzhOFF MzzgOFF MzzgON MzzhON MzzhOFF MzzhON MzzgOFF MzzaON MzzhOFF MzbcOFF MzzaOFF MzzhON MzzaON MzzaOFF MzziON MzziOFF MzzkON MzzhOFF MzzhON MzzkOFF MzzhON MzzhOFF MzzgON MzzhOFF MzazON MzazOFF MzazON MzzgOFF	
aixcg	MzzgON MzazOFF MzzgOFF MzzhON MzzbON MzzcON MzzhOFF MzzbOFF MzzeON MzzcOFF MzzdON MzzeOFF MzzcON MzzbON MzzdOFF MzzbOFF MzzgON MzzcOFF MzzhON MzzgOFF MzzgON MzzhOFF MzzeON MzzeOFF MzazON MzzgOFF MzazOFF MzzkON MzzgON MzzgOFF MzzgON MzzkOFF MzazON MzazOFF MzzgON MzzgOFF MzzgON MzzgOFF
aixch	MzzgON MzzgOFF MzzgON MzzgOFF MzazON MzaaON MzzgON MzzgOFF MzaaON MzaaOFF MzazOFF MzazON MzazOFF	
aixci	MzazON MzzgON MzzgOFF MzazOFF MzzgON MzzgOFF MzzgON MzzgOFF MzazON MzzgON MzzgOFF MzzgON	
aixck	MzazOFF MzazON MzzgOFF MzazOFF MzazON MzazON MzazOFF	
aixdz	MzzgON MzzgOFF MzzgON MzazON MzzgOFF MzazOFF MzzgON MzzgOFF MzzgON MzzgOFF MzazON MzazOFF	
aixda	MzazON MzazOFF MzazON MzazOFF MzazON MzazOFF MzazON MzazOFF
aixdb	MzazON MzazOFF
aixdc	MzazON MzazOFF MzazON MzazOFF
aixde	MzazON MzazOFF
aixdg	MzazON MzazOFF MzazON MzazOFF
aixez	MzzgON MzazON MzzgOFF MzazOFF MzzgON MzzgOFF	
aixea	MzzgON MzzeON MzazON MzzeOFF MzzgOFF MzazOFF MzazON MzazOFF MzzgON MzzgOFF	
aixeb	MzazON MzzgON MzzgOFF MzazOFF
aixec	MzzgON MzzeON MzazON MzzeOFF MzazOFF MzzeON MzzeOFF MzzgOFF MzzgON MzzeON MzzeOFF MzzgOFF MzzgON MzzgOFF MzazON MzazOFF MzzgON MzzgOFF	
aixeg	MzazON MzzgON MzazOFF MzzgOFF MzzgON MzzgOFF MzzgON MzzgOFF MzazON MzazOFF MzzgON MzzgOFF	
aixeh	MzzgON MzzgOFF
aixei	MzazON MzazOFF
akxza	MzzeON MzzeOFF	
akxzb	MzzkON MzzkOFF MzazON MzazOFF	
akxzc	MzazON MzzeON MzzeOFF MzazOFF MzazON MzazOFF
akxzd	MzazON MzazOFF MzazON MzazOFF MzazON MzazOFF MzazON MzazON MzazOFF MzazON MzazOFF
akxze	MzazON MzazOFF MzazON MzazOFF MzazON MzazOFF
akxzg	MzazON MzazOFF	
akxzh	MzazON MzazOFF	
akxzi	MzazON MzazOFF MzazON MzazOFF MzazON MzazOFF	
akxzk	MzzgON MzzkON MzzkOFF MzzgOFF MzzgON MzzgOFF MzazON MzazOFF MzazON MzazOFF MzazON MzazOFF	
akxaz	MzazON MzazOFF MzazON MzazOFF MzazON MzazOFF MzazON MzazOFF MzazON MzazOFF MzazON MzazOFF	
akxaa	MzazON MzazOFF MzazON MzazOFF MzazON MzazOFF MzazON MzazON MzazOFF	
akxab	MzazON MzazOFF	
akxac	MzazON MzazOFF	
akxba	MzazON MzazOFF MzazON MzzkON MzazOFF MzzkOFF MzazON MzazOFF	
akxbb	MzzeON MzzeOFF MzzeON MzzgON MzazON MzzeOFF MzzgOFF MzazOFF	
akxbc	MzzeON MzzgON MzazON MzzeOFF MzzgOFF MzzgON MzazOFF MzazON MzazOFF MzzgOFF MzzgON MzzgOFF MzzgON MzzgOFF MzzgON MzzgOFF MzzgON MzzgOFF MzzgON MzzgOFF MzzgON MzzgOFF MzzeON MzzeOFF	
akxbd	MzazON MzazOFF MzazON MzazOFF MzazON MzazOFF	
akxdb	MzazON MzzgON MzzgOFF MzzgON MzzhON MzazOFF MzziON MzzkON MzzgOFF MzzhOFF MzzkOFF MzzkON MzzhON MzzkOFF MzzgON MzazON MzziOFF	
akxdc	MzzhOFF MzazOFF MzazON MzzgOFF MzazOFF MzazON MzzgON MzzgOFF MzazOFF MzzgON MzazON MzazON MzazOFF MzzgON MzzgOFF MzzgON MzzgOFF	
akxeb	MzzgON MzzgOFF MzzgON MzzgOFF	
akxec	MzzgON MzzgOFF MzzgON MzazON MzzgOFF MzazOFF MzazON MzazOFF	
akxei	MzzgON MzzgOFF	
baxza	MzazON MzazOFF	
baxzh	MzazON MzazOFF	
baxaz	MzazON MzazOFF	
baxde	MzazON MzazOFF
baxdh	MzazON MzazOFF	
bbxag	MzzkON MzzkOFF	
bbxbe	MzazON MzazOFF MzazON MzazOFF	
bbxcb	MzazON MzazOFF	
bbxcd	MzazON MzazOFF	
bbxce	MzazON MzazOFF
bbxdz	MzzkON MzzkOFF
bbxdc	MzazON MzazOFF
bbxdi	MzazON MzazOFF
bbxea	MzazON MzzkON MzzgON MzzkOFF MzzgOFF MzazOFF MzzgON MzzgOFF MzzgON MzzgOFF	
bbxeb	MzzgON MzzgOFF MzzgON MzzgOFF MzzgON MzzgOFF MzzgON MzzgOFF MzzgON MzzhON MzziON MzzkON MzzgOFF MzaeON MzzhOFF MzadON MzziOFF MzacON MzzkOFF MzaeOFF MzabON MzaaON MzacOFF MzabOFF MzadOFF	
bbxec	MzacON MzabON MzaaOFF MzadON MzabOFF MzaeON MzziON MzzkON MzacOFF MzadOFF MzzkOFF MzaeOFF MzzkON MzzhON MzzkOFF MzzgON MzazON MzaaON MzzhOFF MzazOFF MzziOFF MzzgOFF MzaaOFF MzzgON MzzgOFF MzzgON MzzhON MzziON MzzkON MzzgOFF MzzhOFF MzzkOFF MzzkON MzzhON MzzkOFF MzzaON MzbcON MzziOFF MzbbON MzzhOFF MzbaON MzbcOFF MzzaOFF MzbdON MzbbOFF MzbaOFF MzbeON MzbdOFF MzbgON MzbeOFF MzbeON		
bbxed	MzbeOFF MzbhON MzbgOFF MzbiON MzbkON MzczON MzcgON MzbiOFF MzbhOFF MzcgOFF MzcgON MzbkOFF MzceON MzczOFF MzcgOFF MzcgON MzcgOFF MzcgON MzceON MzczON MzcaON MzceOFF MzczOFF MzczON MzcgOFF MzcgON MzcaOFF MzczOFF MzcgOFF MzcgON MzczON MzcaON MzczOFF MzcgOFF MzcgON MzcgOFF MzcgON MzczON MzcaON MzchON MzbkON MzcaOFF
bbxee	MzczOFF MzcgOFF MzbkOFF MzchOFF MzchON MzbkON MzczON MzcgON MzchOFF MzbkOFF MzcaON MzceON MzcbON	
bbxeg	MzczOFF MzcdON MzcaOFF MzcbOFF MzcgOFF MzcgON MzcdOFF MzcgOFF MzceOFF MzceON MzceOFF	
bbxeh	MzceON MzceOFF MzceON MzcdON MzcbON MzcbOFF MzccON MzcbON MzcdOFF MzcdON MzcbON MzccOFF MzcdOFF MzceOFF MzcbON MzceON MzcdON MzcbOFF MzceOFF MzceON MzcbON MzcdOFF MzcdON MzcbOFF MzcdOFF MzceOFF MzceON MzcdON MzcbON MzccON MzccOFF MzcbOFF MzcdOFF MzcbON MzcbOFF MzceOFF MzceON MzcgON
bbxei	MzcdON MzcgOFF MzccON MzccOFF MzceOFF MzceON MzcdOFF MzceOFF MzcdON MzceON MzcdOFF MzcdON MzcdOFF MzcdON	
bbxek	MzcdOFF MzceOFF MzceON MzceOFF MzceON MzcdON MzcdOFF MzceOFF MzceON
zcxbi	MzceON MzcdON MzcdOFF MzceON MzceOFF	
zdxak	MzceON MzceOFF MzceON MzcdON MzceOFF MzcdOFF
zdxcd	MzceON MzcdON MzcdOFF MzceOFF	
zdxce	MzceON MzcdON MzceOFF MzcdOFF MzceON MzcdON	
zdxcg	MzcdOFF MzceOFF	
zdxeg	MzceON MzcdON MzceOFF MzceON MzcdOFF MzcdON MzcdOFF MzceOFF	
zexzh	MzcdON MzceON MzcdOFF MzcdON MzcdOFF MzceOFF	
zexag	MzcdON MzceON MzcdOFF MzceOFF
zexbz	MzceON MzceOFF MzcdON MzceON MzceOFF MzcdOFF
zexba	MzceON MzceOFF	
zexdc	MzcdON MzcdOFF
zgxzh	MzceON MzceOFF MzceON MzceOFF MzceON MzceOFF	
zgxzi	MzceON MzcdON MzcdOFF MzceOFF MzceON MzcdON MzceOFF MzcdOFF MzceON MzceOFF	
zgxac	MzceON MzceOFF
zgxbb	MzceON
zgxbc	MzcdON MzcdON MzceON MzcdOFF MzceOFF MzcdON MzceON MzceOFF MzcdOFF	
zgxbi	MzceON MzceOFF	
zgxce	MzcdON MzceON MzcdOFF MzceON MzcdON MzcdOFF MzceOFF	
zgxdg	MzcdON MzceON MzcdOFF MzcdON MzcdOFF MzceOFF	
zhxzb	MzcdON MzceON MzcdOFF MzceOFF
zhxbk	MzceON MzcdON MzcdOFF MzceOFF MzcdON MzceON MzcdOFF MzceOFF	
zhxcd	MzceON MzcdON MzcdOFF MzcdON MzceOFF MzcdOFF MzceON MzceOFF	
zhxck	MzceON
zhxdz	MzceOFF
zhxeb	MzceON MzcdON MzcdOFF MzceOFF	
zixze	MzceON MzceOFF	
zixac	MzceON MzcdON MzcdOFF MzcdON MzcdOFF MzceOFF	
zixbg	MzceON MzcdON MzcdOFF MzceOFF	 
zixbk	MzceON MzcdON MzccON MzcbON MzcaON MzccOFF MzcdOFF MzcbON MzceOFF MzcbOFF MzceON MzccON MzcdON MzccOFF MzceOFF MzcaOFF MzccON MzceON MzccOFF MzcbOFF MzcdOFF MzcdON MzcdOFF MzceOFF MzceON MzceOFF MzceON MzceOFF MzceON MzcdON MzcdOFF MzcdON MzcdOFF
zixcz	MzcdON MzcdOFF MzceOFF MzceON MzceOFF	
zixdz	MzceON MzceOFF MzceON MzcdON MzcdOFF MzceOFF	
zixde	MzceON MzcdON MzcdOFF MzcdON MzcdOFF MzceOFF MzceON MzceOFF	
zixdg	MzceON MzceOFF MzceON MzceON MzceOFF MzceON MzceOFF	
zixdi	MzceON MzcdON MzcdOFF MzcdON MzcdOFF MzceOFF	
zixez	MzceON MzceOFF MzceON MzceOFF	
zixeb	MzceON MzceOFF MzcdON MzceON MzcdOFF MzcdON MzceOFF MzceON MzcdOFF MzceOFF MzcdON MzceON MzcdOFF MzcdON MzceOFF MzcdOFF MzceON MzcdON MzcdOFF MzcdON MzccON MzceOFF MzccOFF MzcdOFF MzccON MzcbON MzceON MzcgON MzceOFF MzczON MzcbOFF	
zixec	MzbkON MzccOFF MzbiON MzcgOFF MzbhON MzczOFF MzbkOFF MzbiOFF MzbgON MzbhOFF MzbeON MzbgOFF MzbdON MzbeOFF MzbdOFF MzbeON MzbdON MzbdOFF MzbdON MzbaON MzbeOFF MzakON MzbdOFF MzaiON MzbaOFF MzahON MzakOFF MzaiOFF MzagON MzagOFF MzahOFF MzahON MzagON MzagOFF MzahOFF MzahON MzahOFF MzahON MzaiON MzahOFF MzaiOFF MzaiON
zixed	MzaiOFF MzaiON MzakON MzbdON MzbaON MzaiOFF MzbeON MzakOFF MzbaOFF MzbdOFF MzbdON MzbeOFF MzbaON MzakON MzaiON MzahON	
zixee	MzakOFF MzaiOFF MzakON MzbaOFF MzbdOFF MzaiON MzbaON MzahOFF MzbbON MzaiOFF MzbaOFF MzakOFF MzbcON MzzaON MzbcOFF MzbbOFF MzbcON MzbbON MzzaOFF MzbaON MzbcOFF MzbdON MzbeON MzbgON MzbeOFF MzbeON MzbbOFF MzbaOFF MzbdOFF MzbeOFF MzbhON MzbiON MzbkON MzbgOFF MzchON MzczON MzbiOFF MzbhOFF MzchOFF MzcgON MzceON MzbkOFF MzcbON MzcgOFF MzczOFF MzceOFF MzcbOFF MzcbON MzceON MzcgON MzcbON MzcbOFF MzcgOFF MzceOFF
zixeg	MzcaON MzcgON MzcbOFF MzcaON MzcaOFF MzcaOFF MzczON MzbkON MzcgOFF MzczOFF MzbkOFF MzbkON MzczON MzczOFF MzbkOFF MzbkON MzczON MzczOFF	
zixeh	MzbkOFF MzbkON MzczON MzcgON MzbkON MzbkON MzbkON MzbkOFF MzczOFF MzcgON MzcgOFF MzbkOFF MzbkON MzchON MzchOFF MzchON MzbkOFF MzbkON MzchOFF MzbkOFF MzchON MzbkON MzczON MzchOFF MzcgON MzceON MzcbON MzceOFF MzcbOFF MzceON MzczOFF MzcgOFF MzceOFF MzceON MzceOFF MzbkOFF MzbkON MzceON MzceOFF MzczON MzcgON	
zixei	MzcbON MzbkOFF MzczOFF MzczON MzcgON MzcgOFF MzbkON MzbiON MzbhON MzcbON MzcgOFF MzcbOFF MzczOFF MzbgON MzbkOFF MzbiOFF MzbeON MzbhOFF MzbdON MzbaON MzbbON MzbgOFF MzbeOFF MzbcON MzzaON MzzhON MzzgON MzbdOFF MzzaOFF MzbcOFF MzbaOFF MzzaON MzbcON MzzhOFF MzbbOFF MzazON MzaaON MzzcON MzzbON MzbcOFF MzzaOFF MzzgOFF MzaaOFF MzzbOFF MzzbON MzzhON MzaaON MzzgON MzzbOFF MzzhOFF MzaaOFF MzaaON MzzcOFF MzazOFF MzzgOFF MzaaOFF MzzgON MzzgOFF MzzgON MzzgOFF MzaaON MzaaOFF MzazON MzzgON MzaaON MzaaOFF MzazOFF MzzgOFF 
zixek	MzazON MzazOFF
zkxzz	MzaaON MzaaOFF MzaaON MzzgON MzaaOFF MzaaON MzazON MzaaOFF MzzgOFF MzazOFF MzazON MzazOFF MzazON MzzkON MzzkOFF MzzgON MzzgOFF MzzkON MzazOFF MzazON MzzkOFF MzazOFF MzazON MzazOFF MzazON MzazOFF MzazON MzaaON MzazOFF MzzhON
zkxza	MzziON MzaaOFF MzzhOFF MzaeON MzagON MzziOFF MzahON MzaaON MzagOFF MzaeOFF MzaaOFF MzazON MzzgON MzzhON  MzazOFF MzziON MzzkON MzaeON MzagON MzzhOFF MzzkOFF MzziOFF MzzgOFF MzahOFF MzaeOFF MzahON MzagOFF MzagON MzaeON MzahOFF MzahON MzaeON MzagOFF MzaeOFF MzahOFF MzahON
zkxzb	MzahOFF MzahON MzaiON MzaiOFF MzahOFF MzaiON MzahON MzagON MzaiOFF MzahOFF MzahON MzagOFF MzagON MzagOFF MzahOFF MzahON MzahOFF MzahON MzahOFF MzahON MzahOFF MzahON MzaiON MzahON
zkxzc	MzaiOFF MzahOFF MzahON MzaiON MzahOFF MzahON MzaiOFF MzahON MzahOFF MzahON MzahOFF MzahON MzaiON MzahOFF MzaiOFF MzaiON MzahON MzaiOFF MzagON MzaeON MzahOFF MzaeOFF MzagOFF MzagON MzahON MzagOFF MzahOFF
zkxzd	MzahON MzaiON MzahOFF MzahON MzaiOFF MzaiON MzaiOFF MzahOFF MzahON	
zkxze	MzagON MzagOFF MzagON MzaeON MzadON MzacON MzahOFF MzagOFF MzaeOFF MzadOFF MzazON MzazOFF MzazON MzazOFF MzacOFF MzacON MzacON MzacOFF MzacON MzacOFF MzacON MzacOFF MzacON	
zkxzg	MzacOFF MzacON MzacOFF MzacON MzacOFF MzacON MzacOFF MzacON MzacON MzacOFF MzacON MzacOFF MzacON MzacOFF MzacON MzacOFF MzacON MzacOFF MzacON	
zkxzh	MzacOFF MzacON MzacOFF MzacON MzazON MzazOFF MzacOFF MzacON MzacOFF MzacON MzacOFF MzacON MzacOFF MzacON MzacOFF MzacON MzacOFF MzacON
zkxzi	MzacOFF MzazON MzacON MzazOFF MzazON MzacOFF MzacON MzazOFF MzacOFF MzacON MzacOFF MzacON MzacON MzacOFF MzacON MzacOFF MzacON MzacOFF MzacON MzacOFF MzacON MzacON MzacON MzacOFF MzacOFF
zkxzk	MzacON MzacOFF MzacON MzacOFF MzacON MzazON MzazOFF MzacON MzacOFF MzacON MzacOFF MzacON MzacOFF MzacON MzacOFF MzacON MzazON MzacOFF MzazOFF MzacON MzacOFF MzacON MzacOFF
zkxaz	MzacON MzacOFF MzacON MzacOFF MzacON MzacON MzacOFF MzacON MzacOFF MzacON MzacOFF MzacON MzacOFF MzazON MzazOFF MzacON MzacOFF MzacON MzacOFF MzacON MzacOFF	
zkxaa	MzacON MzacOFF MzacON MzacOFF MzacON MzacOFF MzacON MzacOFF MzacON MzacOFF MzacON MzacOFF MzacON	
zkxab	MzacOFF MzacON MzacOFF MzacON MzadON MzacOFF MzaeON MzagON MzahON MzadOFF MzaeOFF MzagOFF MzahOFF MzahON MzagON MzaeON MzadON MzahOFF MzaeOFF MzagOFF MzacON MzadOFF MzadON MzadOFF MzacOFF MzazON MzazOFF MzazON MzazOFF	
zkxac	MzacON MzadON MzadOFF MzacOFF MzadON MzadOFF MzadON MzaeON MzagON MzahON MzagOFF MzadOFF MzaiON MzaeOFF MzahOFF MzaiOFF MzaiON MzahON MzaiON MzahON MzaeOFF MzadOFF MzadON MzadOFF MzacON MzacOFF	
zkxad	MzazON MzazOFF MzadON MzadOFF MzadON MzadOFF MzadON MzazON MzazOFF MzacON MzadOFF MzacOFF MzadON MzadOFF MzadON MzadOFF MzadON MzazON MzazOFF MzadOFF MzadON	
zkxae	MzazON MzadOFF MzazON MzazOFF MzadON MzacON MzadOFF MzazON MzazOFF MzacOFF MzacON MzacOFF MzazON MzazOFF MzazON MzazOFF MzacON MzacOFF MzacON MzadON MzziON MzzkON MzzhON MzadOFF MzacOFF MzzkOFF MzzaON MzbcON MzbbON MzbaON MzbcOFF MzzhOFF MzziOFF MzbdON MzbeON MzzaOFF MzacON MzbgON MzbbOFF MzbaOFF MzbdOFF MzbhON MzbeOFF MzadON MzbiON MzbgOFF MzbkON MzadOFF MzadON MzczON MzcgON MzbiOFF MzbhOFF MzaeON MzagON MzcaON MzacON MzcbON MzahON MzccON MzbkOFF MzceON MzacOFF MzaeOFF MzcdON MzagOFF MzaiON MzadOFF MzczOFF MzcaOFF MzcgOFF MzahOFF MzceOFF MzceON MzccOFF MzcbOFF MzaiOFF
zkxag	MzceON MzcdOFF MzahON MzceOFF MzcdON MzceON MzcdOFF MzceOFF MzccON MzceON MzcbON MzccOFF MzceOFF MzceON MzceOFF MzahOFF MzceON MzcbOFF MzceOFF MzcgON MzczON MzbkON MzbiON MzbhON MzcgOFF MzczOFF MzagON MzbkOFF MzbgON MzahON MzbhOFF MzbiOFF MzagOFF MzbeON MzbdON MzbgOFF MzbaON MzaiON MzakON MzbbON MzbeOFF MzahOFF MzzaON MzbdOFF MzbcON MzbaOFF MzzhON MzbaON MzbbOFF MzaiOFF MzbcOFF MzbbON MzzaOFF MzazON MzzhOFF MzakOFF MzazOFF MzbcON MzbaOFF MzzaON MzbbOFF MzzhON MzbcOFF MzzaOFF MzzkON MzzgON MzzkOFF MzzhOFF MzzgOFF MzazON MzazOFF MzzgON MzzhON MzzgOFF MzzgON MzzhOFF MzzgOFF MzzhON MzzhOFF MzzhON
zkxah	MzzgON MzzhOFF MzzhON MzzgOFF MzzgON MzzgOFF MzzhOFF MzzhON MzzhOFF MzzgON MzzgOFF MzzgON MzzhON MzzgOFF MzzkON MzzgON MzzkOFF MzzhOFF MzzhON MzziON MzzaON MzzgOFF MzbcON MzbcOFF MzzhOFF MzzhON MzzhOFF
zkxai	MzziOFF MzziON MzzaOFF MzzaON MzbcON MzzhON MzbbON MzzhOFF MzbaON MzzaOFF MzbdON MzbcOFF MzbeON MzziOFF MzbbOFF MzbaOFF MzbeOFF MzbdOFF	
zkxcc	MzbdON MzbdOFF MzbdON MzbaON MzbdOFF MzbdON MzbaOFF MzbaON MzbdOFF MzakON MzbaOFF MzakOFF MzakON
zkxcd	MzakOFF MzakON MzbaON MzakOFF MzbaON MzbaOFF MzbaON MzbdON MzbeON MzbaOFF MzbdOFF MzbdON MzbeOFF MzbaON MzbbON MzbdOFF MzbaOFF MzbbOFF MzbbON MzbaON MzbaOFF MzbaON MzbdON MzbbOFF MzbeON MzbaOFF MzbgON MzbdOFF MzbeOFF MzbgOFF MzbhON MzbiON MzbiOFF MzbhOFF
zkxce	MzbiON MzbhON MzbiOFF MzbhOFF MzbgON MzbeON MzbgOFF MzbdON MzbeON MzbaON MzbeOFF MzbbON MzbdOFF MzbaOFF MzbcON MzzaON MzbbOFF MzbcOFF MzzhON MzzhOFF MzziON MzzhON MzzgON MzzaOFF MzziOFF MzzhOFF MzzhON MzziON MzzkON MzaeON MzzgOFF MzagON MzzhOFF MzzkOFF MzahON MzziOFF MzagOFF MzaeOFF MzagON MzaeON MzahOFF MzziON MzagOFF MzzhON MzzaON MzaeOFF MzbcON MzziOFF MzzhOFF MzzaOFF MzbbON MzbaON MzbcOFF MzakON MzbbOFF MzbaOFF MzbaON
zkxcg	MzbbON MzakOFF MzbcON MzzaON MzbaOFF MzbbOFF MzbcOFF MzbcON MzbcOFF MzzaOFF MzzaON MzzhON MzziON MzzaOFF MzzhON MzzkON MzaeON MzzhOFF MzzkOFF MzagON MzziOFF MzagOFF MzahON MzaiON MzaeOFF MzahOFF MzaiON MzaiOFF MzaiON MzahON MzaiOFF MzaiON MzaiOFF
zkxch	MzaiON MzaiOFF MzaiON MzaiOFF MzahOFF MzahON MzaiON MzaiOFF MzahOFF MzahON MzahOFF MzaiON MzahON MzaiOFF MzagON	
zkxci	MzahOFF MzagOFF MzagON MzahON MzaiON MzagOFF MzakON MzahOFF MzbaON MzaiOFF MzbdON MzbdOFF MzakOFF MzbaOFF MzbdON MzakON MzbaON MzaiON MzahON MzbdOFF MzakOFF MzaiOFF MzbaOFF MzahOFF MzahON MzagON MzagOFF MzaiON MzakON MzaiOFF MzahOFF MzaiON MzahON MzakOFF MzaiOFF MzahON
zkxck	MzahOFF MzahON MzahOFF MzahON MzahOFF MzahON MzahOFF MzahON MzahOFF MzahON MzahOFF MzahON MzahOFF MzahON
zkxdz	MzaiON MzahON MzahOFF MzaiOFF MzahON MzaiON MzaiOFF MzahOFF MzahON	
zkxda	MzahOFF MzahON MzaiON MzahOFF MzahON MzaeON MzagON MzadON MzagOFF MzahOFF MzaiOFF MzaeOFF MzadOFF
zkxdb	MzadON MzadOFF MzadON MzacON MzacOFF MzacON MzadOFF MzadON MzacOFF MzadOFF MzacON MzacOFF MzacON MzacOFF MzacON MzacOFF MzacON MzadON MzadOFF MzacOFF MzacON MzadON
zkxdc	MzacOFF MzadOFF MzadON MzadOFF MzadON MzadOFF MzadON MzadOFF MzadON MzacON MzadOFF MzacOFF MzacON MzadON MzadOFF MzacOFF
zkxdd	MzadON MzaeON MzaeOFF MzadOFF MzadON MzadOFF MzadON MzadOFF MzadON MzadOFF MzadON
zkxde	MzadOFF MzadON MzadOFF MzadON MzzkON MzziON MzadOFF MzzhON MzzgON MzzhOFF MzzkOFF MzazON MzaaON MzzgOFF MzziOFF MzazOFF MzaaOFF MzaaON MzazON MzaaOFF MzazOFF MzzgON MzzhON
zkxdg	MzziON MzzkON MzaeON MzagON MzzkOFF MzziOFF MzzhOFF MzahON MzzgOFF MzaeOFF MzagOFF MzaiON MzaeON MzagON MzaiOFF MzadON MzahOFF MzagOFF MzacON MzaeOFF MzadOFF MzacOFF MzacON MzadON MzaeON MzagON MzacOFF MzadOFF MzahON MzagOFF MzaeOFF MzagON MzahOFF MzagOFF MzagON MzaeON MzziON MzzkON MzzhON MzagOFF MzzkOFF MzzgON MzaeOFF MzziOFF MzzhOFF MzzhON MzziON MzzkON MzzhOFF MzadON MzaeON MzzkOFF MzziOFF MzzgOFF MzaeOFF MzadOFF MzadON MzadOFF MzadON MzadOFF
zkxdh	MzadON MzziON MzadOFF MzzkON MzzhON MzzkOFF MzzgON MzziOFF MzzgOFF MzzhOFF MzzhON MzzgON MzziON MzadON MzziOFF MzzhOFF MzzgOFF MzadON MzadOFF MzadON MzadON MzzkON MzziON MzadOFF MzzhON MzzgON MzziOFF MzzkOFF MzzhOFF MzzeON MzzgOFF MzzgON MzzeOFF MzzgOFF MzzeON MzzgON MzzeON MzzeOFF MzzgOFF MzaaON MzzeON MzzeOFF MzaaOFF MzzgON MzzhON
zkxdi	MzziON MzzhOFF MzadON MzziOFF MzzgOFF MzadOFF MzadON MzaeON MzagON MzadOFF MzahON MzaiON MzagOFF MzaeOFF MzahOFF MzahON MzaiOFF MzagON MzaeON MzziON MzzkON MzzhON MzahOFF MzagOFF MzzkOFF MzaeOFF MzzbON MzziOFF MzzhOFF MzzbOFF MzzbON MzzhON MzziON MzzbOFF MzzkON MzaeON MzadON MzzkOFF MzziOFF MzzhOFF MzadOFF MzziON MzzkON MzzhON MzzkOFF MzzaON MzaeOFF MzbcON MzzhOFF MzziOFF MzzaOFF MzbcOFF MzbcON MzzaON MzzhON MzbcOFF MzzgON MzzaOFF MzzhOFF MzzhON MzziON MzzkON MzzgOFF MzadON MzzhOFF MzzkOFF MzziOFF MzadOFF
zkxdk	MzzkON MzziON MzzhON MzzgON MzzkOFF MzziOFF MzzhOFF MzzhON MzzbON MzzgOFF MzzhOFF MzzhON MzzbOFF MzzgON MzzhOFF MzzgOFF MzzgON MzzeON MzzeOFF MzzgOFF MzzgON	
zkxez	MzzhON MzziON MzzkON MzzhOFF MzadON MzzkOFF MzziOFF MzzgOFF MzziON MzzhON MzadOFF MzzgON MzziOFF MzzhOFF MzzhON MzziON MzzhOFF MzziOFF MzadON MzaeON MzzgOFF MzadOFF MzadON MzziON MzzhON MzaeOFF MzzbON MzzcON MzzhOFF MzadOFF MzziOFF MzzbOFF MzzbON MzzhON MzziON MzzcOFF MzzbOFF MzzkON MzaeON MzadON MzzkOFF MzziOFF MzzhOFF MzadOFF MzzkON MzzhON MzziON MzzkOFF MzzbON MzzcON MzaeOFF MzzhOFF MzzbOFF MzziOFF MzzbON MzzhON MzziON MzzbOFF MzzcOFF MzadON MzzhOFF MzziOFF MzacON MzadOFF MzacOFF MzaaON MzacON MzaaOFF MzadON MzaeON MzacOFF MzagON MzadOFF MzahON MzagOFF MzaeOFF MzaiON MzakON MzbaON MzbdON MzahOFF MzaiOFF
zkxea	MzakOFF MzbeON MzbaOFF MzbeOFF MzbaON MzbbON MzbdON MzbcON MzbaOFF MzzaON MzbdOFF MzbbOFF MzzhON MzziON MzbcOFF MzzaOFF MzzhOFF MzzaON MzzaOFF MzzhON MzzaON MzzhOFF MzzhON MzzaOFF MzzhOFF MzzhON MzziOFF MzziON MzziOFF MzziON MzzhOFF MzziOFF MzziON MzziOFF MzziON MzzhON MzbcON MzzaON
zkxeb	MzzhOFF MzbcON MzzaON MzzaOFF MzziOFF MzzhON MzziON MzbcOFF MzzaOFF MzzhOFF MzzhON MzzaON MzbcON MzziOFF MzzaOFF MzzhOFF MzbcOFF MzbcON MzzaON MzzhON MzziON MzbcOFF MzzkON MzzaOFF MzzkOFF MzzkON MzaeON MzzhOFF MzadON MzzkOFF MzziOFF MzadOFF MzaeOFF MzadON MzadON MzaeON MzadON MzaeOFF MzacON MzadOFF MzacOFF MzaaON MzabON MzacON MzaaOFF MzabOFF MzadON MzacOFF MzziON MzzkON MzadOFF MzzkOFF MzzhON MzzgON MzazON MzzhOFF MzazOFF
zkxec	MzziOFF MzzhON MzzgOFF MzziON MzziOFF MzzaON MzbcON MzzhOFF MzbbON MzzaOFF MzbaON MzbcOFF MzbdON MzbbOFF MzbaOFF MzbeON MzbeOFF MzbaON MzbbON MzbcON MzzaON MzbdOFF MzbaOFF MzzhON MzbbOFF MzbcOFF MzzgON MzzaOFF MzzhOFF MzzgOFF MzzgON MzzgOFF MzzgON MzzgOFF MzzgON MzzgOFF MzzgON MzzgOFF MzzgON MzzgOFF
zkxed	MzazON MzzgON MzazOFF MzazON MzazOFF MzzeON MzzgOFF MzzgON MzzhON  MzzeOFF MzziON MzziOFF MzzgOFF MzziON MzziOFF MzzaON MzzaOFF MzzbON MzzcON MzzhOFF MzzbOFF MzzcOFF MzzcON MzzbON MzzhON MzzbOFF MzziON MzzcOFF MzzkON MzzhOFF MzaeON MzagON MzziOFF MzzkOFF MzziON MzzkON MzagOFF MzaeOFF MzzhON MzzcON MzzbON MzzhOFF MzzbOFF MzziOFF MzzkOFF MzzbON MzzhON
zkxee	MzzcOFF MzzbOFF MzzbON MzzcON MzzbOFF MzzhOFF MzzbON MzzhON MzzbOFF MzzcOFF MzzaON MzbcON MzbbON MzbaON MzzhOFF MzzaOFF MzbcOFF MzbdON MzbbOFF MzbeON MzbaOFF MzbaON MzakON MzbeOFF MzbaOFF MzaiON MzbdOFF MzahON MzaiOFF MzaiON MzakOFF MzaiOFF MzaeON MzagON MzziON MzzkON MzagOFF MzzhON MzzkOFF MzzbON MzaeOFF MzzbON MzahOFF MzzhOFF MzziOFF MzzbOFF MzzcON MzzcOFF MzzcON MzzgON MzzgOFF MzzhON MzzaON MzzcOFF MzzaOFF MzzhOFF MzzbON MzzcON MzzaOFF MzzdON MzzbOFF MzzcOFF MzzdOFF MzzdON MzzcON MzzbON MzzhON MzzdOFF MzziON MzzbOFF MzzcOFF MzzkON
zkxeg	MzzhOFF MzaeON MzzkOFF MzziOFF MzahON MzaiON MzakON MzaeOFF MzbaON MzbdON MzahOFF MzbeON MzaiOFF MzakOFF MzbaOFF MzbdOFF MzbeOFF MzbeON MzbgON MzbeOFF MzbgOFF MzbhON MzbiON MzbkON MzczON MzbiOFF MzbhOFF MzcgON MzbkOFF MzcbON MzcaON MzcaOFF MzcgOFF MzcbOFF MzcbON MzczOFF MzcaON MzcaOFF MzcaON MzcaOFF MzcaON MzcaOFF MzceON MzcdON MzcdOFF MzceOFF MzcbOFF MzcdON MzceON MzceON MzceOFF MzceON MzccON MzceOFF MzccON MzccOFF MzcdOFF
zkxeh	MzccON MzccOFF MzccON MzccOFF MzccON MzcdON MzccOFF MzcdOFF MzcdON MzccON MzcdOFF MzcdON MzceON MzccOFF MzcdOFF MzcdON MzccON MzceOFF MzccOFF MzcdOFF MzcdON MzcdOFF MzcdON MzccON MzceON MzccOFF MzcdOFF MzcdON MzcdOFF MzcdON MzceOFF MzceON MzccON MzccOFF MzceOFF MzcdOFF
zkxei	MzcdON MzccON MzceON MzcbON MzccOFF MzceOFF MzceON MzcdOFF MzccON MzceOFF MzcbOFF MzccOFF MzccON MzcbON MzcgON MzcaON MzccOFF MzcaOFF MzcbOFF MzcgOFF MzcgON MzcaON MzcgOFF MzcaOFF MzcaON MzcgON MzcgOFF MzcgON MzcaON MzczON MzcgOFF MzcaOFF MzczOFF MzczON MzcgON MzbkON MzczOFF MzcgOFF MzchON MzbkOFF MzchOFF
zkxek	MzchON MzbkON MzbiON MzchOFF MzbhON MzbkOFF MzbiOFF MzbhOFF MzbgON MzbeON MzbdON MzbgOFF MzbaON MzbbON MzbeOFF MzbdOFF MzbcON MzbaOFF MzzaON MzbbOFF MzzbON MzbcOFF MzzaOFF MzzcON MzzcOFF MzzbOFF MzzcON MzzbON MzzhON MzzbOFF MzziON MzzcOFF MzzkON MzaeON MzzhOFF MzzkOFF MzagON MzziOFF MzahON MzagOFF MzaiON MzaeOFF MzahOFF MzakON MzbaON MzbdON MzbeON MzbaOFF MzaiOFF MzakOFF MzbgON MzbdOFF MzbeOFF MzbhON MzbgOFF MzazOFF MzazON MzazOFF MzazON MzazOFF
baxza	MzaaON MzazON MzazOFF MzaaOFF MzaaON MzazON MzzeON MzaaOFF MzzgON MzzeOFF MzzeON	
baxzb	MzzgOFF MzazOFF MzazON MzzgON MzzeON MzzeOFF MzazOFF MzzgOFF MzazON MzzgON MzzgOFF MzazOFF MzazON MzazOFF MzazON MzzgON MzaaON MzzgOFF MzazOFF MzaaOFF	
baxzc	MzzgON MzaaON MzzgOFF MzaaOFF
baxzd	MzazON MzazOFF	
baxze	MzazON MzaaON MzazOFF	
baxzg	MzaaOFF MzazON MzazOFF MzazON MzazOFF MzazON MzazOFF
baxzh	MzazON MzazOFF MzazON MzazOFF
baxzi	MzazON MzazOFF MzazON MzaaON MzaaOFF MzazOFF
baxzk	MzaaON
baxaz	MzaaOFF MzaaON MzazON MzaaOFF MzazOFF MzazON MzzgON MzazOFF MzzgOFF MzaaON MzaaOFF MzaaON MzaaOFF MzaaON MzaaOFF MzaaON MzaaOFF MzaaON MzaaOFF MzaaON MzaaOFF MzaaON MzzgON MzzgOFF MzaaON MzaaOFF MzzgON MzzgOFF
baxaa	MzaaON MzaaOFF MzaaON MzaaOFF
baxac	MzazON MzzgON MzaaON
baxad	MzzgOFF MzaaOFF MzazOFF MzazON MzzgON MzazOFF MzzgOFF MzzgON MzzgOFF MzazON MzazOFF MzaaON MzazON MzzgON 
baxae	MzaaOFF MzazOFF MzazON MzzgOFF MzaaON MzzgON MzaaOFF MzazOFF MzzgOFF MzaaON
baxag	MzaaOFF MzaaON MzazON MzzgON MzazOFF MzaaOFF MzzgOFF MzazON MzazOFF MzzgON MzzgOFF MzzgON MzazON MzazOFF MzzgOFF
baxah	MzzgON MzazON MzazOFF MzzhON MzziON MzzkON MzzgOFF MzaeON MzagON MzzhOFF MzzkOFF MzziOFF MzahON MzagOFF MzaeOFF MzahOFF MzahON
baxai	MzahOFF MzahON MzahOFF MzahON MzahON MzahOFF MzahON MzaiON MzakON MzahOFF MzakOFF MzakON MzbaON MzbdON MzaiOFF MzbeON MzbgON MzakOFF MzbaOFF MzbdOFF MzbhON MzbeOFF MzbiON MzbgOFF MzbkON MzchON MzbiOFF MzbhOFF MzbkOFF MzchOFF
baxcd	MzchON MzbkON MzbiON MzchOFF MzbhON MzbkOFF MzbiOFF MzbhOFF MzbhON MzbhOFF MzbgON MzbeON MzbdON MzbgOFF MzbaON MzbeOFF MzbbON MzbdOFF MzbcON MzzaON MzbaOFF MzzhON MzziON MzbbOFF MzbcOFF MzzaOFF MzziOFF MzzgON MzzhOFF MzazON MzzgOFF MzazOFF MzazON MzzgON MzazOFF
baxce	MzzgOFF MzzgON MzzgOFF MzzgON MzzhON MzzhOFF MzzgOFF MzzhON MzzhOFF MzzhON MzzhOFF MzzhON MzzhOFF MzzhON MzzgON MzzeON MzzhOFF MzzgOFF	
baxcg	MzzeOFF MzzeON MzzeOFF MzzeON MzzeOFF MzzeON MzzgON MzzhON MzzeOFF MzziON MzzkON MzzgOFF MzzhOFF MzadON MzzkOFF MzziOFF MzacON MzadOFF MzabON MzacOFF MzabOFF MzabON MzaaON MzabOFF MzaaOFF MzaaON
baxch	MzaaOFF MzaaON MzabON MzaaON MzaaOFF MzacON MzaaOFF MzadON MzabOFF MzacOFF MzadOFF MzziON MzzkON MzzkOFF MzzhON MzzgON MzziOFF MzzkON MzzkOFF MzzhOFF MzzgOFF MzzhON MzzgON MzzhOFF MzzgOFF MzzgON MzzgOFF MzzgON MzzgOFF MzzgON
baxci	MzzgOFF MzzgON MzzhON MzzgOFF MzziON MzzgON MzzaON MzbcON MzzgOFF MzzhOFF MzziOFF MzbbON MzbaON MzbcOFF MzzaOFF MzakON MzaiON MzahON MzbbOFF MzbaOFF MzakOFF MzaiOFF MzahOFF MzahON MzahON MzahOFF MzahON MzahOFF MzahON MzaiON MzakON MzahOFF MzbaON MzaiOFF MzbdON MzakOFF
baxck	MzbaOFF MzbdOFF MzbdON MzbeON MzbeOFF MzbeON MzbdOFF MzbdON MzbeOFF MzbdOFF
zgxzz	MzceON MzceOFF MzcdON MzceON MzcdOFF MzceOFF MzceON MzceOFF
zgxzc	MzceON MzcdON MzceOFF MzcdOFF
zgxzd	MzceON MzcdON MzceOFF MzcdOFF MzceON MzceOFF MzcdON MzceON
zgxze	MzcdOFF MzcdON MzcdOFF MzcdON MzceOFF MzcdOFF
zgxzh	MzceON MzcdON MzceON MzceOFF MzceOFF MzceON MzcdOFF MzceON MzcdON MzcdOFF MzceOFF
zgxdz	MzcdON MzceON MzcdOFF MzcdON MzceOFF MzcdOFF
zgxdb	MzcdON MzceON MzceOFF MzceON MzceOFF MzcdOFF MzceON MzcdON MzcdOFF MzceOFF MzceON MzcdON
zgxdc	MzcdOFF MzceON MzceOFF MzceOFF
zgxeg	MzcdON MzcdOFF
zgxei	MzceON MzceOFF MzceON MzcdON MzcdOFF MzceOFF
zhxzz	MzceON MzceOFF MzceON MzcdON MzcdOFF MzceOFF MzceON MzceOFF  	
zhxzk	MzceON MzcdON MzcdOFF MzceON MzceOFF
zhxaz	MzceOFF
zhxac	MzceON MzceOFF MzceON MzceOFF
zhxad	MzceON MzceOFF MzceON MzcdON MzcdOFF MzceOFF MzceON MzcdON MzcdOFF MzceOFF
zixzz	MzceON MzceOFF MzcdON MzceON MzcdOFF MzcdON MzcdOFF MzcdON MzccON MzcbON MzccOFF MzcgON MzcaON MzceOFF MzcdOFF MzcbOFF MzcgOFF MzcaOFF MzcgON MzcaON MzcbON MzccON MzceON MzcgOFF MzcdON MzcaOFF MzcbOFF MzceOFF MzccOFF MzcdOFF MzcdON MzceON MzccON MzccOFF
zixza	MzcdOFF MzcdON MzcdOFF MzceOFF
zixzc	MzcdON MzceON MzcdOFF MzceOFF
zixze	MzceON MzcdON MzcdOFF MzceOFF MzceON MzceOFF MzceON MzcdON MzcdOFF MzceOFF MzceON MzceOFF
zixzg	MzceON MzcdON MzcdOFF MzceOFF 
zixaz	MzceON MzcdON MzcdOFF MzcdON MzcdOFF MzceOFF MzceON MzceOFF MzceON MzcdON MzcdOFF MzcdON MzcdOFF MzceON MzceOFF
zixaa	MzceON MzcdON MzcdOFF MzceOFF
zixae	MzceON MzceOFF MzceON MzcdON MzcdOFF MzceOFF
zixbz	MzceON MzceOFF MzceON MzcdON MzceOFF MzcdOFF MzceON MzceOFF
zixba	MzceON MzceOFF
zixbe	MzceON MzcdON MzcdOFF MzcdON MzcdOFF MzceOFF MzceON MzceOFF
zixdb	MzcdON MzceON MzcdOFF MzcdON MzcdOFF MzcgON MzcgOFF MzceOFF
zixdc	MzceON MzceOFF MzceON MzceOFF MzceON MzcdON MzcdOFF MzceOFF MzceON MzceOFF MzceON MzceOFF
zixdd	MzceON MzcdON MzccON MzccOFF MzccON MzcbON MzcaON MzcgON MzceOFF MzceON MzczON MzccOFF MzbkON MzcbOFF MzcaOFF MzchON MzceOFF MzcdOFF MzcgOFF MzczOFF MzchON MzbkOFF MzchOFF	
zixea	MzchON MzbkON MzczON MzcgON MzcaON MzcbON MzchOFF MzczOFF MzbkOFF MzcaOFF MzcgOFF MzceON MzceOFF MzcaON MzcgON MzceON MzcgOFF MzcaOFF MzcaON MzceOFF MzcaOFF MzceON MzcgON MzcaON
zixeb	MzcbOFF MzceOFF MzcgOFF MzcaOFF MzcaON MzcgON MzcgOFF MzcbON MzceON MzceOFF MzcaON MzcaOFF MzcbON MzcbOFF MzcbON MzcbOFF MzcbON MzceON MzceOFF MzcbOFF MzcbON
zixec	MzcbOFF MzcbON MzceON MzcbOFF MzcbON MzccON MzcdON MzcbON MzcbOFF MzceOFF MzccOFF MzcdOFF MzcdON MzccON MzccOFF MzccON MzccOFF MzccON MzccOFF MzccON MzcdOFF MzccOFF MzccON MzccOFF MzccON MzccOFF MzcdON MzccON MzcdOFF MzccOFF
zixed	MzcdON MzccON MzceON MzcbON MzcaON MzcgON MzcbOFF MzceOFF MzczON MzbkON MzcdOFF MzcaOFF MzccOFF MzchON MzczOFF MzcgOFF MzbkOFF MzchOFF MzchON MzbkON MzczON MzcgON MzceON MzchOFF
zixee	MzczOFF MzbkOFF MzcgOFF MzceOFF MzcaON MzcaOFF MzceON MzcbON MzcbOFF MzcbON MzceOFF MzcbOFF MzcbON MzcbOFF MzcbON MzcbOFF MzcbON MzceON MzcaON MzceOFF MzcbOFF MzcaOFF MzcbON
zixeg	MzcaON MzcaOFF MzcbOFF MzcaON MzcbON MzcaOFF MzcgON MzceON MzcaON MzcgON MzcbOFF MzcgOFF MzceOFF MzcaOFF MzcaON MzcbON MzcbOFF MzcbON MzcbOFF MzcgON MzczON MzcaOFF MzbkON MzczOFF MzcgOFF MzbiON MzbhON MzbkOFF MzbiOFF MzbhOFF MzbhON MzbhOFF MzbgON MzbeON MzbgOFF
zixeh	MzbdON MzbeOFF MzbaON MzbbON MzbcON MzbdOFF MzzaON MzbaOFF MzbbOFF MzziON MzzkON MzbcOFF MzzaOFF MzzkOFF MzzkON MzzkON MzaeON MzagON MzziOFF MzzkOFF MzaeOFF MzahON MzagOFF MzahOFF MzagON MzahON MzahOFF MzagOFF MzagON MzaeON MzaeOFF MzagOFF MzahON MzahOFF MzahON MzagON MzaeON MzahOFF MzaeOFF MzaeON MzaeOFF
zixei	MzahON MzagOFF MzagON MzahOFF MzagOFF MzagON MzahON MzagOFF MzahOFF MzahON MzahOFF MzahON MzaiON MzahOFF MzahON MzaiON MzaiOFF MzahOFF MzahON MzagON MzaeON MzagOFF MzzkON MzahOFF MzaeOFF MzzkOFF MzziON MzziOFF MzaeON MzagON MzagOFF MzadON MzaeOFF MzadOFF MzzkON MzadON MzzkOFF MzacON MzadOFF MzadON MzadOFF MzadON
zixek	MzadON MzadOFF MzacOFF MzacON MzacON MzadON MzaeON MzacOFF MzadOFF MzagON MzaeOFF MzahON MzagOFF MzahOFF MzahON MzagON MzagOFF MzagON MzaeON MzahOFF MzziON MzzkON MzagOFF MzaeOFF MzziOFF MzaeON MzagON MzzkOFF MzahON MzaeOFF MzagOFF MzahOFF
zkxzz	MzagON MzaeON MzagOFF MzadON MzadON MzaeOFF MzaeON MzagON MzadOFF MzahON MzagOFF MzakON MzaiON MzaeOFF MzahOFF MzbaON MzbdON MzbeON MzaiOFF MzakOFF MzbaOFF MzbdOFF MzbeOFF MzbdON MzbaON MzakON MzbaOFF MzaiON MzbdOFF MzahON MzakOFF MzagON MzaeON MzaiOFF MzahOFF MzagOFF MzaeOFF MzaeON MzadON MzadOFF MzagON MzagOFF MzagON
zkxza	MzaeOFF MzahON MzaiON MzagOFF MzahOFF MzahON MzaiOFF MzahOFF MzahON MzahOFF
zkxzb	MzagON MzaeON MzagOFF MzaeOFF MzaeON MzagON MzahON MzaeOFF MzagOFF MzahOFF MzahON MzahOFF MzahON MzagON MzaeON MzahOFF MzahON MzagOFF MzaeOFF MzagON MzaeON MzaeOFF MzahOFF MzaeON MzaeOFF MzagON MzagOFF
zkxzc	MzagON MzagOFF MzagON MzagOFF MzagON MzagOFF MzaeON MzagON MzaeOFF MzagOFF MzagON MzahON MzagOFF MzagON MzagOFF MzagON MzahOFF MzagOFF MzagON MzagOFF MzagON MzaeON MzziON MzzkON MzagOFF MzaeOFF
zkxzd	MzziOFF MzzkOFF MzzkON MzzkOFF MzzkON MzziON MzzkOFF MzziOFF MzziON MzzkON MzzkOFF MzziOFF MzziON MzziOFF MzziON MzziOFF MzziON MzziOFF MzziON MzzkON MzziOFF MzzkOFF MzagON MzaeON MzagOFF MzaeOFF MzagON MzahON MzaiON MzakON MzakON MzaiOFF MzagOFF MzbaON MzahOFF MzbdON MzakOFF
zkxze	MzbaOFF MzbdOFF MzbdON MzbdOFF
agxeh	MzbdON MzbeON MzbdOFF MzbeOFF MzbdON MzbeON MzbeOFF MzbaON MzbdOFF MzbbON MzbcON MzbaOFF MzbbOFF MzzhON MzzaON MzzaOFF MzbcOFF MzzgON MzzhOFF
agxei	MzzkON MzzhON MzziON MzzkOFF MzzkON MzziOFF MzziON MzzgOFF MzzhOFF MzzgON MzzhON MzzkOFF MzziOFF MzzhOFF MzzgOFF MzzgON MzzgOFF MzzgON MzzhON MzzhOFF MzzgOFF MzazON MzzgON MzazOFF MzzgOFF MzzgON MzzgOFF MzzgON MzzgOFF MzzgON MzazON MzaaON MzzgOFF MzaaOFF MzazOFF MzazON MzaaON MzazOFF MzaaOFF	
agxek	MzaaON MzazON MzaaOFF MzazOFF MzazON MzazOFF MzazON MzazOFF MzazON MzazOFF MzazON MzazOFF
ahxzb	MzzgON MzzgOFF
ahxzc	MzzgON MzzgON MzzgOFF
ahxze	MzazON
ahxzg	MzaaON MzazOFF MzaaOFF MzaaON MzaaOFF MzaaON MzaaOFF MzaaON MzaaOFF
ahxzh	MzaaON MzaaOFF MzaaON MzaaOFF MzzgON MzzgOFF
ahxzk	MzazON MzazOFF MzazON MzazOFF
ahxaz	MzazON MzazOFF MzaaON MzzgON MzzgOFF MzaaOFF
ahxab	MzazON MzaaON MzazOFF MzaaOFF MzzgON MzzgOFF
ahxac	MzazON MzazOFF MzazON MzazOFF
ahxae	MzaaON MzazON
ahxag	MzaaOFF MzazOFF MzaaON MzazON MzaaOFF MzazOFF MzaaON MzaaOFF
ahxah	MzazON MzazOFF	
ahxai	MzazON MzazOFF MzazON MzaaON MzzgON MzaaOFF MzazOFF MzzgOFF MzaaON MzzgON MzaaOFF MzzgOFF MzaaON MzaaOFF MzaaON MzaaOFF
ahxak	MzaaON MzaaOFF MzaaON
ahxbz	MzaaOFF MzaaON MzzgON MzaaOFF MzzgOFF MzazON MzazOFF MzazON MzazOFF MzazON MzaaON MzazOFF MzaaOFF
ahxba	MzzgON MzzgOFF
ahxbc	MzzgON MzzgOFF MzazON MzazOFF MzzgON MzzgOFF
ahxbg	MzzgON MzzgOFF MzazON MzzgON MzazOFF MzzgOFF MzazON MzazOFF
ahxbh	MzazON MzzgON MzazOFF MzzgOFF MzzgON MzzgOFF 
ahxbi	MzzgON MzzgOFF MzzgON MzzgOFF MzzgON MzzgOFF MzzgON MzzgON MzzgOFF MzzgON MzzgOFF
ahxcz	MzaaON MzaaOFF MzzgON MzzgOFF
ahxca	MzaaON MzaaOFF MzaaON MzzgON MzaaOFF MzzgOFF MzzgON MzzeON MzazON MzzeOFF MzzeON MzzeOFF MzzeON MzazOFF MzzgON MzzeOFF MzzgOFF
ahxcb	MzazON MzazOFF MzazON MzzgON MzazOFF MzzgOFF MzazON MzzgON MzzgON MzazOFF MzzgOFF MzzgON MzzgOFF MzazON MzazOFF MzazON MzzgON
ahxcc	MzazOFF MzzgOFF MzzgON MzzgOFF MzazON MzazOFF MzazON MzazOFF MzazON MzazOFF MzzgON MzzgOFF
ahxcd	MzzgON MzzgOFF MzzgON MzzgOFF MzzgON MzazON MzzgOFF MzazOFF
ahxce	MzazON MzazOFF MzazON MzazOFF
ahxci	MzazON MzazOFF MzazON MzazON MzzgON MzazOFF MzazON MzaaON MzazOFF MzaaOFF MzzgOFF MzaaON MzaaOFF
ahxdc	MzzgON MzzgOFF MzzgON MzzgOFF MzazON MzazOFF MzazON MzazOFF MzazON MzazOFF
ahxdd	MzazON MzazOFF MzazON MzazOFF MzazON MzazOFF MzazON MzazOFF MzazON MzazOFF
ahxde	MzzgON MzzgOFF MzzgON MzzgOFF
ahxez	MzazON MzazOFF MzaaON MzaaOFF MzaaON MzaaOFF MzaaON MzzgON MzzgOFF MzaaOFF MzazON MzazOFF
ahxeb	MzaaON MzazON
ahxec	MzaaOFF MzazOFF MzaaON MzaaOFF
ahxeg	MzaaON MzaaOFF
ahxeh	MzzgON MzzgOFF
ahxek	MzazON MzazOFF
aixzz	MzzgON MzzgOFF
aixza	MzzgON MzzgOFF
aixzg	MzaaON MzaaOFF MzaaON MzaaOFF MzaaON MzazON MzzgON MzzeON MzaaOFF MzzeOFF MzzeON MzzeOFF MzzeON MzazOFF MzzgOFF MzzeOFF
aixaz	MzazON MzazOFF
aixaa	MzazON MzzgON MzazOFF MzazON MzzeON MzzgOFF MzzgON MzzeOFF MzazOFF MzzgOFF
aixae	MzazON MzzgON MzzgOFF MzzgON MzzgOFF MzazOFF
aixbz	MzzgON MzzhON MzziON MzzkON MzzgOFF MzaeON MzzhOFF MzzkOFF MzziOFF MzagON MzahON MzaeON MzahOFF MzahON MzaeOFF MzahOFF MzahON MzagOFF MzahOFF MzahON MzahOFF MzahON
aixba	MzagON MzaeON MzzkON MzziON MzagOFF MzzhON MzaeOFF MzahOFF MzzkOFF MzzgON MzzhOFF MzazON MzziOFF MzazOFF MzazON MzazOFF MzzgOFF MzzgON MzzgOFF MzzgON MzzgOFF MzzgON MzzgOFF MzzgON MzzgOFF MzzgON MzzgOFF MzzgON MzzgOFF MzzgON MzzgOFF MzazON MzzgON MzazOFF MzzgOFF MzazON MzazOFF MzazON MzzgON
aixbb	MzazOFF MzzgOFF MzzeON MzzgON MzzeOFF MzzgOFF MzzgON MzzgOFF MzzgON MzzeON MzzeOFF MzzgOFF MzzgON MzzgOFF MzzgON MzzgOFF
aixbc	MzzgON MzzgOFF MzzeON MzzgON MzzeOFF MzzgOFF MzzgON MzzeON MzzgON MzzgOFF MzzeOFF MzzgOFF MzzeON MzzgON MzzgOFF MzzeOFF
aixbd	MzzgON MzzeON MzazON MzzgOFF MzzeOFF MzazOFF
aixbg	MzzgON MzzgOFF MzzgON MzzeON MzzgOFF MzzeOFF
aixbi	MzzgON MzzgOFF MzzgON MzzeON MzzeOFF MzzgOFF MzzgON MzzgOFF MzzgON MzzeON MzzeOFF MzzgOFF MzzgON
aixbk	MzzgOFF MzzgON MzzeON MzzeOFF MzzgOFF MzazON MzazOFF
aixcz	MzzgON MzzgOFF MzzeON MzzgON MzzeOFF MzzgOFF MzzgON MzzgOFF MzzgON MzzeON MzzeOFF MzzgOFF
aixca	MzzgON MzzeON MzzeOFF MzzgOFF MzzgON MzzgOFF MzzeON MzzgON MzzeOFF MzzgOFF MzzgON MzazON MzzgOFF MzzgON MzazOFF MzzgOFF MzzgON MzzgOFF	
aixce	MzazON MzazOFF
aixcg	MzazON MzazON MzazOFF
aixdb	MzazON MzazOFF
aixdh	MzazON MzzgON MzzhON MzziON MzzgOFF MzazOFF MzzaON MzzaOFF MzaeON MzagON MzzhOFF MzziOFF MzahON MzahOFF MzahON MzaeOFF MzagON MzagOFF MzahOFF MzahON MzahOFF MzahON MzagON MzagOFF MzagON MzagOFF MzaeOFF MzzhOFF MzazON MzaaON MzziOFF MzaaOFF MzazOFF 
aixdi	MzaaON MzaaOFF MzaaON MzaaOFF MzazON MzazOFF MzaaON MzaaOFF MzaaON MzaaOFF MzaaON MzaaOFF
aixdk	MzazON MzazOFF MzazON MzazOFF MzazON MzazOFF
aixea	MzazON MzazOFF MzaaON MzaaOFF MzaaON MzaaOFF MzazON MzazOFF
aixec	MzaaON MzaaOFF
aixed	MzzgON MzzgOFF MzaaON MzazON MzaaOFF MzazOFF
aixee	MzaaON MzazON MzazOFF MzaaOFF MzzgON MzzgOFF MzaaON MzaaOFF MzaaON MzaaOFF
akxzc	MzaaON MzaaOFF MzaaON
akxzd	MzaaOFF MzazON MzazOFF
akxze	MzaaON MzaaOFF
akxzi	MzzgON 
akxzk	MzzgOFF MzazON MzzgON MzzgOFF MzzgON MzzgOFF MzazOFF
akxba	MzazON MzaaON MzazOFF MzaaON MzaaOFF
akxbc	MzaaON MzaaOFF MzazON MzazOFF
akxbe	MzaaON MzaaOFF
akxbg	MzaaON MzaaOFF	
akxbh	MzazON
akxbi	MzazON MzazOFF 
akxcz	MzazON MzzgON MzzhON MzziON MzzgOFF MzzkON MzazOFF MzaeON MzagON MzzhOFF MzzkOFF MzziOFF MzaeOFF MzagOFF MzagON MzahON MzahOFF MzahON MzaiON MzagOFF MzahOFF	
akxca	MzahON MzaiOFF MzagON MzaeON MzziON MzzkON MzagOFF MzaeOFF MzziOFF MzaaON MzazON MzzkOFF MzahOFF MzazOFF MzaaOFF
akxcc	MzazON MzzgON MzzgOFF MzazOFF MzazON MzazOFF MzazON MzaaON MzazOFF MzaaOFF MzazON MzazOFF MzaaON MzaaOFF MzazON MzazOFF MzazON MzaaON MzazOFF MzaaOFF	
akxcd	MzaaON MzaaOFF MzaaON MzaaOFF MzaaON MzaaON MzaaOFF	
akxdz	MzaaON MzaaOFF	
akxdc	MzzgON MzzgOFF
bzxzz	MzazON MzazOFF MzazON MzazOFF	
bzxzc	MzzgON MzazON MzzgOFF MzazOFF MzaaON MzaaOFF
bzxze	MzaaON MzazON MzazOFF MzaaOFF MzaaON MzaaOFF MzazON MzazOFF
bzxzh	MzazON MzzgON MzazOFF MzzgOFF MzzgON MzzgOFF MzzhON MzziON MzzkON MzaeON MzagON MzzkOFF MzzhOFF MzziOFF MzagOFF MzagON MzaeOFF MzagOFF MzaeON MzagON MzadON MzagOFF
bzxzi	MzadOFF MzadON MzagON MzaeOFF MzadOFF MzaeON MzahON MzaeOFF MzagOFF MzahOFF MzagON MzahON MzagOFF MzagON MzahOFF MzagOFF MzagON MzaeON MzagOFF MzagON MzaeOFF MzagOFF MzagON MzaeON MzaeOFF MzaeON MzagOFF MzagON MzaeOFF MzagOFF MzagON	
bzxzk	MzaeON MzaeON MzahON MzaiON MzakON MzaeON MzaeOFF MzbdON MzbaON MzbeON MzaiOFF MzahOFF MzagOFF MzbgON MzakOFF MzbaOFF MzbeOFF MzbdOFF MzbhON MzbgOFF MzbkON MzchON MzbiOFF MzbhOFF MzbkOFF MzchOFF
bzxab	MzchON MzbkON MzbiON MzbhON MzchOFF MzbkOFF MzbgON MzbiOFF MzbhOFF MzbeON MzbdON MzbaON MzbgOFF MzaiON MzbaOFF MzahON MzbdOFF MzakOFF MzaiOFF MzahOFF MzagON MzaeON MzagOFF MzaeOFF
bzxac	MzzkON MzzkOFF MzzkON MzzkOFF MzzkON MzzkOFF MzaeON MzagON MzagOFF MzaeOFF
bzxad	MzzkON MzzkOFF MzzkON MzaeON MzagON MzzkOFF MzaeOFF MzagOFF MzagON MzaeON MzagOFF MzagON MzaeOFF MzaeON MzaeOFF
bzxae	MzaeON MzaeOFF MzaeON MzaeOFF MzagOFF MzagON MzagOFF MzagON MzagOFF MzagON MzagOFF MzagON MzagOFF MzagON MzagOFF MzagON MzagOFF MzagON MzagON MzagOFF MzagON
bzxag	MzagOFF MzagON MzagOFF MzagON MzagOFF MzagON MzagOFF MzagON MzahON MzahOFF MzaeON MzziON MzzkON MzzhON MzzgON MzaeOFF MzzkOFF MzagOFF MzzhOFF MzziOFF MzazON MzazOFF	
bzxah	MzzgOFF MzzgON MzazON MzzgOFF MzazOFF MzazON	
bzxai	MzazOFF 
bzxak	MzazON MzzgON MzazOFF MzzgOFF MzazON MzaaON MzazOFF MzaaOFF MzaaON MzaaOFF
bzxbz	MzaaON MzaaOFF MzaaON MzaaOFF MzaaON MzaaOFF
bzxba	MzaaON MzaaON MzaaOFF MzaaOFF MzazON MzazOFF MzazON MzzgON MzazOFF MzzgOFF MzzgON MzazON MzzgOFF MzazOFF MzaaON MzaaOFF
bzxbb	MzaaON MzaaOFF MzaaON MzaaOFF MzaaON MzaaOFF MzaaON MzaaOFF MzaaON MzaaOFF MzaaON MzaaOFF MzaaON MzaaOFF MzaaON MzaaOFF
bzxbc	MzaaON MzaaOFF MzaaON MzaaOFF MzaaON MzaaOFF
bzxbd	MzaaON MzaaOFF	
bzxbg	MzazON MzazOFF MzazON MzazOFF
bzxbh	MzaaON MzaaOFF MzaaON MzaaOFF MzaaON MzaaOFF	
bzxbk	MzaaON MzaaOFF	
bzxcz	MzazON MzaaON MzazOFF MzaaOFF
bzxcc	MzaaON MzaaOFF MzaaON MzaaOFF MzaaON MzaaON MzaaOFF MzzgON MzazON MzzgOFF MzazOFF
bzxcd	MzaaON MzaaOFF MzaaON MzaaOFF MzazON MzaaON MzazOFF MzaaOFF	
bzxch	MzaaON MzazON	
bzxci	MzaaOFF MzazON MzazOFF MzazON MzazOFF MzazON MzazOFF	
bzxck	MzazON MzazOFF MzazON MzzgON MzzhON MzziON MzzgOFF MzazOFF
bzxdz	MzaeON MzagON MzzhOFF MzziOFF MzahON MzaeOFF MzahOFF MzagOFF MzagON MzaeON MzziON MzzkON MzagOFF MzzhON MzaeOFF MzzgON MzzkOFF MzziOFF MzzhOFF MzzkON MzziON MzzhON MzziON MzzgOFF MzziOFF MzzhOFF MzziOFF MzzkOFF MzzkON MzzkOFF MzzkON MzzhON MzzkOFF MzzkON MzzhOFF MzzhON MzzhOFF MzzkOFF
bzxda	MzzgON MzazON MzzgOFF MzazON MzazOFF	
bzxdb	MzazON MzzgON MzzgOFF MzazOFF MzazON MzazOFF
bzxdi	MzzgON MzzgOFF	
bzxea	MzazON MzazON MzazOFF
bzxeg	MzazON MzazOFF MzazON MzazOFF
baxzd	MzazON MzazOFF	
baxze	MzazON MzazOFF	
baxzk	MzazON MzzkON MzzhON MzazOFF MzzhOFF MzzkOFF MzzkON MzazON MzzgON MzzgOFF MzzkOFF MzazOFF MzzgON MzzgOFF MzzgON MzzgOFF MzzgON MzzgOFF MzazON MzazOFF	
baxaz	MzazON MzazOFF MzazON MzaaON MzazOFF MzaaOFF MzaaON MzazON MzaaOFF MzazOFF MzzgON MzzgOFF MzazON MzazOFF MzazON MzazOFF MzazON MzazOFF	
bbxaa	MzazOFF
bbxab	MzaaON MzaaOFF
bbxae	MzzgON MzzgOFF MzazON MzazOFF MzazON MzaaON MzaaOFF MzazOFF MzaaON MzazON MzaaOFF MzazOFF	
bbxag	MzaaON MzaaOFF MzazON MzaaON MzaaOFF MzazOFF
bbxbd	MzazON MzazOFF	
bbxbi	MzazON MzazOFF MzazON MzazOFF
bbxbk	MzazON MzazOFF MzaaON MzaaOFF MzazON MzazOFF MzazON MzazOFF MzazON MzazOFF
bbxch	MzazON MzzgON MzzeON MzzgOFF MzazOFF MzzeOFF MzzgON MzzhON MzziON MzzgOFF MzzkON MzaeON MzagON MzzhOFF MzahON MzzkOFF MzziOFF MzaiON MzagOFF MzaeOFF MzaiOFF MzaiON MzakON MzahOFF MzbaON MzbdON MzbeON MzaiOFF MzbgON MzakOFF MzbdOFF MzbaOFF MzbhON MzbeOFF MzbiON MzbgOFF MzbkON MzchON MzbiOFF MzbhOFF MzbkOFF MzchOFF
bbxck	MzchON MzbkON MzczON MzchOFF
bbxdz	MzbkOFF MzbkON MzbiON MzbhON MzczOFF MzbkOFF MzbiOFF MzbgON MzbhOFF MzbeON MzbgOFF MzbdON MzbeOFF MzbeON MzbdOFF MzbdON MzbaON MzbbON MzbeOFF MzbdOFF MzbcON MzbaOFF MzbbOFF MzzaON MzzhON MzziON MzzaOFF MzbcON MzziOFF MzbcOFF MzazON MzaaON MzzgON MzzhOFF MzzgOFF MzaaOFF MzazOFF MzaaON MzaaOFF MzaaON MzazON MzaaOFF MzzeON MzzgON MzazOFF MzzeOFF MzzgOFF	
bbxeb	MzazON MzaaON MzaaOFF MzazOFF MzaaON MzaaOFF
zgxze	MzchON MzbkON MzczON	
zgxzg	MzchOFF MzczOFF MzczON MzcgON MzcaON MzcbON MzcbOFF MzczOFF MzcgOFF MzcbON MzcaOFF MzbkOFF MzcaON MzceON MzcaOFF MzceOFF MzceON MzcaON MzcaOFF MzceOFF MzcaON MzcaOFF MzcaON MzcaOFF MzcbON MzcgON MzcaON MzcgOFF MzcgON MzcgOFF MzcbOFF MzcgON MzcaOFF MzcaON MzcbON MzcbOFF MzcgOFF MzcaOFF MzcbON MzcaON MzcbON MzcbOFF
zgxzh	MzcaOFF MzcaON MzcbON MzcaOFF MzceON MzceOFF MzcbON MzccON MzcbOFF MzcdON MzceON MzcdOFF MzccOFF MzcdON MzcdOFF MzceOFF MzcdON MzceON MzcbON MzcdOFF MzceOFF MzcbOFF MzcbON MzceON MzceOFF MzcbOFF MzceON MzcbON MzcbON MzcbOFF MzcbON MzcbOFF MzcgON MzcdON MzcdOFF MzcgON MzcgOFF MzceOFF
zgxzk	MzceON MzcdON MzcbON MzcdOFF MzceOFF MzcbOFF MzceON MzceOFF MzcbON MzcbOFF MzcbON MzcbOFF MzcbON MzccON MzcdON MzceON MzccOFF MzcdOFF MzcbOFF MzcdON MzceOFF MzcdOFF MzcdON MzcdOFF MzcdON MzceON MzcdOFF MzcdON MzcdOFF MzceOFF MzceON MzceOFF MzcdON MzcdOFF MzceON MzcdON
zgxaz	MzcbON MzcaON MzcdOFF MzceON MzceOFF MzcaOFF MzceON MzcgON MzczON MzbkON MzceOFF MzchON MzcgOFF MzcbOFF MzczOFF MzbkOFF MzchOFF
zgxaa	MzchON MzchOFF MzchON MzbkON MzczON MzchOFF MzbkOFF MzbkON MzbiON MzczOFF MzbhON MzbiOFF MzbkOFF MzbhOFF MzbgON MzbeON MzbgOFF MzbdON MzbeOFF MzbdOFF MzbdON MzbeON MzbeOFF MzbaON MzakON MzbdOFF MzaiON MzbaOFF MzakOFF MzaiOFF MzaiON
zgxab	MzaiOFF MzaiON MzaiOFF MzaiON MzahON MzaiOFF MzahOFF MzahON MzahOFF MzahON MzahOFF MzahON
zgxac	MzahOFF MzahON MzahOFF MzahON MzagON MzaeON MzadON MzahOFF MzagOFF MzacON MzaeON MzaeOFF MzacOFF MzaeON MzagON MzaeOFF MzadOFF MzahON MzagOFF MzagON
zgxad	MzaeON MzahOFF MzaeOFF MzagOFF MzaeON MzagON MzagOFF MzaeOFF MzagON MzaeON MzagOFF MzaeOFF MzaeON MzagON MzaeOFF MzagOFF MzagON MzagOFF MzagON MzaeON MzaeOFF MzagOFF MzagON MzaeON MzahON MzaeOFF MzagOFF MzahOFF MzahON MzahOFF MzahON
zgxae	MzahOFF MzahON MzagON MzaeON MzahOFF MzadON MzacON MzagOFF MzacOFF MzaeOFF MzacON MzacOFF MzadOFF MzacON MzacOFF MzacON MzadON MzaeON MzagON MzacOFF MzahON MzadOFF MzaeOFF MzagOFF MzahOFF MzahON MzahOFF MzahON MzahOFF	
zgxag	MzahON MzahOFF MzahON MzahOFF MzagON MzahON MzagOFF MzahOFF MzahON MzagON MzaeON MzadON MzahOFF MzacON MzaeOFF MzagOFF MzadOFF MzadON MzadOFF MzacOFF MzacON MzadON MzadOFF MzadON MzacOFF MzacON MzacOFF MzacON MzadOFF MzadON
zgxah	MzacOFF MzadON MzadOFF MzadON MzadOFF MzacON MzadON MzadOFF MzacOFF MzacON MzacOFF MzadON MzadOFF MzacON MzadON MzacOFF MzadOFF	
zgxai	MzacON MzacOFF MzadON MzacON MzadOFF MzacOFF MzadON MzadOFF
zgxbz	MzadON MzadOFF MzadON MzadOFF MzadON MzadOFF MzacON MzacOFF MzacON MzadON MzacOFF MzacON MzadOFF MzadON MzacOFF MzacON MzadOFF MzacOFF	
zgxba	MzadON MzadOFF	
zgxbb	MzacON MzacOFF MzadON MzadOFF MzadON MzadOFF MzadON MzadOFF MzacON MzacOFF	
zgxbc	MzacON MzadON MzacOFF MzadOFF MzadON MzadOFF MzacON MzacOFF MzacON MzadON MzacOFF MzadOFF 	
zgxbd	MzadON MzadOFF MzadON MzadOFF
zgxbe	MzadON MzadOFF MzadON MzadOFF MzadON MzadOFF MzadON MzacON	 
zgxbg	MzadON MzziON MzacOFF MzzkON MzzhON MzzaON MzbcON MzzkOFF MzzhOFF MzadOFF MzbbON MzbaON MzbcOFF MzziOFF MzzaOFF MzbdON MzbeON MzbbOFF MzbaOFF MzbgON MzbdOFF MzbeOFF MzbhON MzbgOFF MzbiON MzbkON MzbiOFF MzbhOFF MzchON MzchOFF MzbkOFF MzbkON MzchON MzcgON MzczON MzcbON MzceON MzccON MzchOFF MzczOFF MzbkOFF MzcdON MzcgOFF MzceOFF MzcbOFF MzcdOFF MzccOFF MzcdON MzccON MzcbON MzceON MzcgON MzcdOFF MzceOFF MzczON MzbkON MzccOFF MzcbOFF MzcaON MzcbON MzbkOFF MzceON MzcdON MzcaOFF MzcgOFF MzczOFF MzcbOFF MzcdOFF
zgxbh	MzcbON MzcdON MzcgON MzcdOFF MzbkON MzczON MzchON MzcbOFF MzczOFF MzcgOFF MzceOFF MzbkOFF MzchOFF MzchON MzchOFF
zgxcd	MzchON MzbkON MzczON MzchOFF MzcgON MzbkOFF MzczOFF MzcgOFF MzcgON MzcaON MzcbON MzcgOFF MzceON MzcaOFF MzcbOFF MzceOFF MzceON MzceOFF
zgxce	MzceON MzceOFF MzcbON MzceON MzcdON MzcdOFF MzcdON MzccON MzcbOFF MzccOFF MzceON MzcdOFF MzceOFF MzceON MzcdON MzcdOFF MzcdON MzceOFF MzcdOFF	
zgxcg	MzceON MzcdON MzcdOFF MzcbON MzceOFF MzceON MzcgON MzcgOFF MzcbOFF MzcbON MzceOFF MzcbOFF MzcbON MzcbOFF MzcbON MzcbOFF MzcbON MzcaON MzcbOFF MzcgON MzcbON MzcgOFF
zgxch	MzcbOFF MzcaOFF MzcaON MzcaOFF MzcbON MzcaON MzcbOFF MzcbON MzcbOFF MzcaOFF MzcaON MzcaOFF MzcaON MzcbON MzcaOFF MzcgON MzcbOFF MzczON MzbkON MzczOFF MzbiON MzcgOFF MzbhON MzbkOFF MzbhOFF MzbhON MzbiOFF MzbgON MzbhOFF MzbeON MzbdON MzbgOFF MzbaON MzbeOFF MzakON MzaiON MzbdOFF MzahON MzbaOFF MzakOFF MzagON MzaeON MzaiOFF MzadON MzahOFF MzaeOFF MzagOFF MzadOFF	
zgxci	MzadON MzaeON MzagON MzahON MzagOFF MzadOFF MzaeOFF MzaiON MzahOFF MzahON MzahON MzaiOFF MzahOFF	
zgxck	MzahON MzahOFF MzahON MzahOFF MzahON MzahOFF MzahON MzahOFF MzagON MzahON MzagOFF MzahOFF	
zgxdz	MzahON MzahOFF MzahON MzahOFF MzahON MzahOFF MzahON MzahOFF	
zgxda	MzahON MzahOFF MzahON MzaiON MzagON MzaeON MzaiOFF MzahOFF MzagOFF MzaeOFF MzaeON MzagON MzahON MzagOFF MzaiON MzakON MzaeOFF MzaiOFF MzahOFF MzbaON MzbdON MzakOFF MzbaOFF MzbeON MzbgON MzbeON MzbdOFF MzbeOFF MzbhON MzbgOFF MzbiON MzbkON MzczON MzbiOFF MzbhOFF MzcgON MzcbON MzbkOFF MzczOFF MzceON MzcgOFF MzcbOFF MzceOFF	
zgxdb	MzceON MzcgON MzcgOFF MzcbON MzceOFF MzcaON MzcaOFF MzcbOFF MzcbON MzcbOFF MzcbON MzcaON MzcbOFF MzcbON MzcaOFF MzcgON MzceON MzcbOFF MzcaON MzceOFF MzczON MzcaOFF MzczOFF MzczON MzbkON
zgxdc	MzbiON MzcgOFF MzbhON MzczOFF MzbkOFF MzbiOFF MzbhOFF MzbgON  MzbeON MzbgOFF MzbdON MzbaON MzbeOFF MzakON MzbaOFF MzbdOFF MzbaON MzbdON MzbeON MzakOFF MzbeOFF MzbaOFF MzbeON MzbeOFF MzbdOFF MzbeON MzbdON MzbeOFF MzbdOFF MzbdON MzbdOFF
aexzz	MzazON MzzgON MzazOFF MzazON MzzgOFF MzzgON MzzgOFF MzazOFF MzzgON MzzhON MzziON MzzaON MzbcON MzzgOFF MzbbON MzziOFF MzzaOFF MzzhOFF MzbcOFF MzbaON MzbdON MzbeON MzbaOFF MzbbOFF MzbgON MzbhON MzbdOFF MzbeOFF MzbiON MzbkON MzbgOFF MzczON MzcgON MzbiOFF MzbhOFF MzcaON MzceON MzcbON MzbkOFF MzcdON MzcgOFF MzczOFF MzcaOFF MzcbON MzcbOFF MzcdOFF	
aexza	MzceOFF MzceON MzceOFF MzceON MzceOFF MzceON MzceOFF MzceON MzceOFF
aexzc	MzceON MzcdON MzcdOFF MzceOFF	
aexzd	MzceON MzceOFF	
aexcz	MzceON MzceOFF MzceON MzceOFF	
aexcc	MzceON MzceOFF MzceON MzceOFF	
aexce	MzceON MzceOFF MzceON MzceOFF MzceON MzceOFF MzceON MzceOFF MzceON MzceOFF
aexcg	MzceON MzcdON MzccON MzceOFF MzceON MzccOFF MzccON MzccOFF MzccON MzccOFF MzcdOFF MzceOFF MzcdON MzceON MzceOFF MzccON MzccOFF MzccON MzccOFF MzceON MzccON MzceOFF MzccOFF MzcdOFF
aexch	MzccON MzcdON MzceON MzceOFF MzcdOFF MzccOFF MzccON MzccOFF MzccON MzcdON MzceON MzcbON MzceOFF MzceON MzccOFF MzcdOFF MzceOFF MzceON MzcgON MzcgOFF MzceOFF MzcbOFF MzcbON MzcbOFF MzcbON MzcbOFF MzcbON MzcbOFF
aexci	MzcbON MzcbOFF MzceON MzcbON MzcgON MzcbOFF MzceOFF MzcgOFF MzcbON MzcbOFF MzcbON MzcaON MzcaOFF MzceON MzcaON MzcaOFF MzcbOFF MzcbON MzcgON MzceOFF MzczON MzcbOFF MzbkON MzcgOFF MzbiON MzbhON MzczOFF MzbkOFF MzbiOFF MzbhOFF MzbgON MzbeON MzbgOFF MzbeON MzbeOFF MzbdON MzbdOFF MzbeOFF MzbeON MzbdON MzbeOFF MzbdOFF
bzxei	MzbdON MzbeON MzbaON MzbbON MzbeOFF MzbcON MzbaOFF MzbdOFF MzzaON MzbbOFF MzziON MzzhON MzbcOFF MzziOFF MzzaOFF MzzhOFF MzzkON MzzkOFF MzzgON	
bzxek	MzzkON MzzgOFF MzzkOFF MzzgON MzzgON MzzgOFF MzzgON MzazON MzaaON MzazOFF MzzgOFF MzazON MzaaOFF MzazOFF MzazON MzaaON MzazOFF MzazON MzaaOFF MzazOFF MzzgON MzzgOFF MzzgON MzzgON MzziON MzzhON MzzgOFF MzzhOFF MzagON MzaeON MzziOFF MzagOFF MzaeOFF MzagON MzagOFF MzagON MzagOFF MzagON MzaeON
baxzz	MzagOFF MzaeOFF MzaeON MzziON MzzkON MzzhON MzaeOFF MzzkOFF MzzgON MzziOFF MzzhOFF MzzgOFF MzzgON MzzgOFF MzzgON MzzgOFF MzazON MzazOFF MzzgON MzazON MzzgOFF MzazOFF	
baxze	MzazON MzazOFF MzazON MzazOFF MzazON MzazOFF
baxzh	MzazON MzzgON MzazOFF MzzgOFF	
baxzi	MzzgON MzzgOFF	
baxzk	MzazON MzazOFF MzazON MzazOFF MzazON MzazOFF MzazON MzazOFF	
baxaa	MzzgON MzzgOFF
baxab	MzazON MzazOFF	
baxac	MzazON MzazOFF MzazON MzazOFF MzazON MzazOFF	
baxag	MzazON MzazON MzazOFF MzazON MzazOFF MzazON MzzgON MzzgOFF MzazOFF	
baxah	MzazON MzazOFF	
baxai	MzazON MzazOFF	
baxbz	MzazON
baxba	MzazOFF
baxbe	MzazON MzaaON MzaaOFF MzazOFF
baxbg	MzazON MzazOFF	
baxbh	MzazON MzazOFF	
baxbk	MzazON MzazOFF	 
baxcz	MzazON MzazOFF MzazON MzazOFF MzzgON MzaaON MzazON MzaaOFF MzazOFF MzzgOFF
baxcb	MzazON MzazOFF	
baxcc	MzazON MzazOFF MzazON MzazOFF	
baxci	MzazON MzazOFF
baxck	MzaaON MzaaOFF MzaaON MzaaOFF
baxdz	MzaaON MzaaOFF MzaaON MzaaOFF MzaaON MzaaOFF MzaaON MzaaOFF MzaaON MzaaOFF
baxda	MzazON MzazOFF	
baxdb	MzaaON MzaaOFF MzazON MzazOFF
baxdc	MzaaON MzaaOFF MzaaON MzaaOFF MzaaON MzaaOFF MzaaON MzaaOFF
baxdd	MzazON MzazOFF	
baxdg	MzazON MzazOFF MzazON MzazOFF
baxeb	MzazON MzazOFF	
baxee	MzzgON MzazON MzzgOFF MzazOFF
bbxzz	MzzgON MzaaON MzazON MzaaOFF MzzhON MzazOFF MzziON MzzkON MzzgOFF MzaeON MzagON MzzkOFF MzzhOFF MzziOFF MzaeOFF MzagOFF MzahON MzahOFF	
bbxza	MzahON MzahOFF MzahON MzagON MzahOFF MzaeON MzagOFF MzzkON MzziON MzzhON MzzkOFF MzaeOFF MzzgON MzzhOFF MzziOFF MzzhON MzziON MzzaON MzbcON MzziOFF MzbbON MzzhOFF MzbaON MzbcOFF MzzgOFF MzzaOFF MzbbOFF MzakON MzbdON MzakOFF MzbeON MzbaOFF MzbeOFF MzbdON MzbdOFF MzbdON MzbeON MzbeOFF MzbdOFF
bbxak	MzbdON MzbeON MzbeOFF MzbeON MzbaON MzbeOFF MzbdOFF MzbbON MzbaOFF MzbcON MzbbOFF MzzaON MzzhON MzzaOFF MzbcOFF MzzgON MzzhOFF MzzgOFF MzzgON MzzgOFF MzzgON
bbxbz	MzzgOFF MzzgON MzzgOFF MzzgON MzzgOFF MzzgON MzzgOFF MzzgON MzzgOFF MzzgON MzzgOFF MzzgON MzzgOFF MzzgON MzzgOFF MzazON MzazOFF MzazON	
bbxba	MzazOFF
bbxbc	MzazON MzzgON MzazOFF MzzgOFF MzzgON MzzgOFF MzazON MzazOFF MzazON MzazOFF	
bbxbe	MzazON MzazOFF MzzgON MzzgOFF	
bbxbg	MzazON MzzgON MzazOFF MzzgON MzzgOFF MzzgON MzzgOFF	
bbxbi	MzazON MzazOFF
bbxca	MzazON MzzgON	
bbxcb	MzzgOFF MzazOFF MzzgON MzazON MzazOFF MzzgOFF MzazON MzazOFF	
bbxcc	MzazON MzazOFF MzzgON MzzgOFF MzazON MzzgON MzazOFF MzzgOFF
bbxcd	MzzgON MzzgOFF MzazON MzazOFF
bbxce	MzazON MzazOFF MzazON MzazOFF MzzgON MzzgOFF MzazON MzzgON MzzgOFF MzzgON MzzhON MzziON MzazOFF MzzkON MzzgOFF MzaeON MzagON MzzkOFF MzzhOFF MzziOFF MzahON MzaeOFF MzahOFF MzagOFF MzagON MzaeON	
bbxcg	MzziON MzzkON MzagOFF MzzhON MzzgON MzzhOFF MzaeOFF MzzkOFF MzziOFF MzzgOFF MzzgON MzzgOFF MzzgON MzzgOFF MzzgON MzzgOFF MzzgON MzazON MzzgOFF MzazOFF MzazON MzazOFF	
bbxck	MzzgON MzaaON MzazON MzazOFF MzaaOFF MzazON MzazOFF MzzhON MzziON MzzkON MzzgOFF MzzhOFF MzzkOFF MzaeON MzziOFF MzagON MzahON MzagOFF MzaeOFF MzagON MzaeON MzagOFF MzadON MzahOFF MzagON MzahON MzadOFF MzagOFF MzaeOFF MzahOFF MzagON MzaeON MzadON MzadOFF MzzkON MzziON MzzhON MzagOFF MzaeOFF MzzgON MzzhOFF MzziOFF MzzkOFF
bbxdz	MzzgOFF MzzgON MzzgOFF MzzgON MzzgOFF MzzgON MzzgOFF MzzgON MzzgOFF MzzgON MzzgOFF MzzgON MzzhON MzziON MzzkON MzzgOFF MzaeON MzagON MzzkOFF MzziOFF MzzhOFF MzagOFF
bbxda	MzaeOFF MzagON MzaeON MzziON MzzkON MzzhON MzagOFF MzaeOFF MzzkOFF MzzgON MzzhOFF MzziON MzziOFF MzzgOFF MzzgON MzziON MzzhON MzzkON MzaeON MzagON MzzkOFF MzzhOFF MzziOFF MzzgOFF MzziON MzzkON MzzhON MzaeOFF MzagOFF MzzgON MzziOFF MzzkOFF MzzhOFF MzazON MzzgOFF MzazOFF MzzgON MzazON
bbxdb	MzazOFF MzzgOFF MzazON MzazOFF MzazON MzazOFF MzazON MzazOFF
bbxdc	MzzgON MzazON MzazOFF MzzgOFF MzzgON MzzgOFF MzazON MzazOFF
bbxde	MzzgON MzzgOFF MzazON MzazOFF MzzgON MzzgOFF MzzgON	
bbxdg	MzzgOFF MzzgON MzzgOFF MzzgON MzzgOFF
bbxdh	MzzgON MzzgOFF	
bbxdk	MzaaON MzaaOFF	
bbxed	MzzgON MzazON MzaaON MzzgOFF MzazOFF MzaaOFF MzzgON MzzgOFF MzaaON MzazON MzzgON MzaaOFF MzazOFF MzzgOFF MzzgON MzzgOFF MzzgON	
bbxee	MzzgOFF MzazON MzazOFF	
bbxeg	MzzgON MzzgON MzzgOFF MzzgON MzzgOFF MzzgON MzzgOFF
bbxeh	MzzgON MzzgOFF MzazON MzazOFF MzazON MzazOFF MzazON MzazOFF MzzgON MzzgOFF MzaaON MzzgON MzaaOFF MzazON	
bbxei	MzaaON MzaaOFF MzazOFF MzzgOFF MzaaON MzaaON MzaaOFF MzazON MzazOFF MzazON MzazOFF
zgxze	MzceON MzceOFF	
zgxaz	MzceON MzceOFF	
zgxbg	MzceON MzcdON MzcdOFF MzcdON MzcdOFF MzceOFFMzcdOFF MzceOFF MzceON MzcdON MzcdOFF MzceOFF
zgxbi	MzceON MzceOFF
zgxcd	MzceON MzceOFF
zgxdd	MzceON MzceOFF MzceON MzceOFF MzcdON MzceON MzcdOFF MzcdON MzcdON MzcdOFF MzcdON MzcdOFF MzceOFF
zhxzb	MzceON MzcdON MzcdOFF MzceOFF
zhxcz	MzceON MzcdON MzcdOFF MzceOFF MzceON MzceOFF MzceON MzceOFF MzceON MzcdON
zhxca	MzcdOFF MzceOFF MzceON MzceOFF
zhxcc	MzceON MzceOFF
zhxcd	MzceON MzceOFF MzceON MzcdON
zhxce	MzcdOFF MzcdON MzcdOFF MzcdON MzcdOFF MzceOFF
zhxdk	MzceON MzceOFF MzceON MzcdON MzcdOFF MzcdON MzcdOFF MzcdON MzcdOFF MzceOFF
zhxed	MzceON MzcdON MzceOFF MzceON
zhxee	MzcdOFF MzceOFF	
zhxek	MzceON MzcdON MzceON MzceOFF MzcdOFF
zixzz	MzceON MzcdON MzcdOFF MzcdON MzcdOFF MzcdON MzcgON MzcgOFF MzcdOFF MzcdON MzcdOFF MzceOFF
zixza	MzceON MzceOFF
zixze	MzceON MzcdON MzcdOFF MzcdON MzcdOFF MzceOFF
zixaz	MzceON MzceOFF MzceON MzceOFF MzceON MzceOFF
zixae	MzceON MzcdON MzcdOFF MzcdON MzcdOFF MzcdON MzcdOFF MzceOFF MzceON MzceOFF
zixcc	MzceON MzceON MzceOFF MzceON MzceOFF
zixeb	MzceON MzceON MzceOFF MzceOFF
zixed	MzceON MzceOFF	
zkxzz	MzceON MzcdON MzcdOFF MzceOFF MzceON
zkxza	MzcdON MzcdOFF MzcdON MzcdOFF MzcdON MzcdOFF MzcdON MzcdON MzcdOFF MzceOFF
zkxac	MzceON MzceON MzceOFF MzceOFF
zkxbc	MzceON MzceOFF
zkxbd	MzceON MzceOFF
zkxeg	MzcdON MzceON MzcdOFF MzcdON MzceOFF MzceON
zkxeh	MzcdOFF MzceOFF MzceON MzceOFF MzceON MzceOFF MzceON MzcdON MzceOFF MzcdOFF MzcdON MzceON MzcdOFF MzceOFF
ahxcg	MzbdON MzbeON MzbeOFF MzbaON MzbbON MzbcON MzbdOFF MzbaOFF MzzaON MzbbOFF MzbcON MzbcOFF MzbcOFF MzzhON MzziON MzzkON MzzaOFF MzzkOFF MzzhOFF MzzgON MzziOFF MzzgOFF MzazON MzazOFF
ahxch	MzaaON
ahxci	MzaaOFF MzaaON MzaaOFF MzazON MzazOFF MzaaON MzaaOFF MzaaON MzaaOFF
ahxck	MzaaON MzaaOFF MzaaON MzaaOFF
ahxdz	MzazON MzazOFF MzazON MzazOFF MzaaON MzaaOFF MzazON MzazOFF MzaaON MzazON MzaaOFF MzazOFF
ahxda	MzaaON MzaaOFF MzazON MzaaON MzzgON MzazOFF MzaaOFF MzzgOFF MzazON MzazON MzazON MzaaON MzazOFF
ahxdb	MzaaOFF MzzgON MzaaON MzaaOFF MzaaON MzzgOFF MzaaOFF
ahxdc	MzzgON MzzgOFF MzaaON MzazON MzazOFF
ahxdd	MzaaON MzazON MzaaOFF MzzgON MzzgOFF MzazOFF MzazON MzaaON MzazOFF MzaaOFF
ahxde	MzazON MzzgON MzazOFF MzaaON MzazON MzazOFF
ahxdg	MzzgON MzaaOFF MzzgOFF MzzgON MzaaON MzaaOFF MzzgOFF MzazON MzazOFF MzaaON MzaaOFF MzazON MzaaON MzazOFF MzaaOFF
ahxdi	MzazON MzazOFF MzazON MzazOFF
ahxez	MzaaON MzaaOFF
ahxeb	MzaaON MzaaOFF MzazON MzazOFF
ahxee	MzazON MzazOFF MzaaON MzaaOFF MzzgON MzazON MzaaON
ahxeg	MzaaOFF MzaaON MzazOFF MzzgOFF MzaaON MzzgON MzaaOFF MzzgOFF MzaaON MzaaOFF MzaaON MzaaOFF
ahxeh	MzaaON MzaaOFF
ahxei	MzazON MzazOFF MzazON MzazOFF
ahxek	MzaaON MzaaOFF MzaaON MzaaOFF
aixzz	MzaaON MzzgON MzazON MzazOFF MzzgOFF MzaaOFF
aixza	MzazON MzaaON MzazOFF MzaaOFF
aixzh	MzaaON MzazON MzazOFF MzaaOFF MzazON MzazOFF MzazON MzaaON MzaaOFF MzazOFF
aixzi	MzaaON MzaaOFF
aixzk	MzzgON MzzgOFF	
aixaa	MzaaON MzzgON MzzgOFF MzaaOFF MzaaON MzzgON MzzgOFF
aixab	MzaaOFF
aixad	MzaaON MzaaOFF MzaaON MzaaOFF
aixai	MzaaON MzaaOFF MzaaON MzaaOFF
aixbz	MzzgON MzazON MzazOFF MzzgOFF
aixba	MzazON MzazOFF MzazON MzazOFF
aixbb	MzazON MzazOFF	
aixbc	MzaaON MzzgON MzaaOFF MzzgOFF
aixbd	MzzgON MzzgOFF MzaaON MzaaOFF MzaaON MzaaOFF MzaaON MzaaOFF MzaaON MzzgON MzzgOFF MzaaOFF
aixbe	MzaaON MzaaOFF MzaaON MzaaOFF MzaaON MzaaOFF MzzgON MzzgOFF
aixbg	MzaaON MzzgON MzzgOFF MzazON MzaaOFF MzazOFF MzaaON MzaaOFF MzaaON MzaaOFF MzzgON MzzgOFF MzzgON MzzgOFF
aixbh	MzaaON
aixbi	MzaaOFF MzazON MzzgON MzaaON MzazOFF MzaaOFF MzzgOFF MzzgON MzzgOFF
aixbk	MzaaON MzaaOFF MzaaON MzzgON MzaaOFF MzzgOFF MzzgON MzazON MzzgOFF MzazOFF MzazON MzazOFF MzazON MzazOFF
aixcz	MzazON MzzgON MzazOFF MzazON MzazOFF MzzgOFF MzazON MzazOFF MzazON
aixca	MzazOFF
aixcc	MzazON MzzgON MzzgOFF MzazOFF
aixce	MzzgON MzzgOFF	
aixcg	MzaaON MzazON MzazOFF MzazON MzaaOFF MzazOFF MzzgON MzzeON MzzeOFF MzazON MzzgOFF MzazOFF MzaaON
aixch	MzaaOFF MzaaON MzazON MzaaON MzazOFF MzaaOFF MzaaON MzaaOFF
aixci	MzaaON MzaaOFF MzaaON MzaaOFF
aixck	MzaaON MzazON MzazOFF MzaaOFF MzaaON MzazON MzzgON MzzgOFF MzazOFF MzaaOFF
aixdz	MzaaON MzaaOFF MzaaON MzaaOFF
aixda	MzaaON MzzgON MzazON MzaaOFF MzazOFF MzzgOFF
aixdc	MzaaON MzaaOFF
aixdd	MzazON MzazOFF MzaaON MzaaOFF MzaaON MzaaOFF
aixde	MzaaON MzazON MzazOFF
aixdg	MzazON MzaaOFF MzazOFF MzaaON MzaaOFF
aixdh	MzaaON MzaaOFF MzaaON MzaaOFF
aixdi	MzazON MzaaON MzazOFF MzaaOFF MzazON MzaaON MzzgON MzazOFF MzaaOFF MzzgON MzaaON MzzgOFF MzazON MzazOFF MzzgON MzaaOFF MzazON MzaaON MzaaON MzzgOFF MzazOFF MzaaOFF MzaaON MzaaOFF
aixez	MzaaON MzaaOFF
aixea	MzaaON MzaaOFF	
aixeb	MzaaON MzaaOFF MzaaON MzaaOFF MzaaON MzazON MzazON MzzgON MzazOFF MzzgOFF MzaaOFF MzaaON MzaaOFF MzaaON MzaaOFF
aixec	MzaaON MzaaOFF MzaaON MzaaOFF MzzgON MzzgOFF MzzgON MzaaON MzzgOFF MzaaOFF MzazON MzazOFF
aixed	MzaaON MzaaOFF MzaaON MzaaOFF MzaaON MzzgON MzazON MzaaOFF MzazOFF MzzgOFF MzazON MzazOFF MzaaON MzaaOFF
aixee	MzaaON MzazON MzaaOFF MzzgON MzzeON MzzeOFF MzazOFF MzzgOFF MzzeON MzzgON MzzeOFF MzzgOFF MzaaON MzaaOFF
aixeg	MzaaON MzaaOFF
aixei	MzaaON MzaaOFF MzaaON MzaaOFF
aixek	MzaaON MzaaOFF MzaaON MzaaOFF MzaaON MzaaOFF MzaaON MzaaOFF MzzgON MzaaON MzazON MzzgOFF MzazOFF MzaaOFF MzzgON MzazON
akxzz	MzzgOFF MzazOFF MzzgON MzzgOFF MzzgON MzzgOFF MzaaON MzaaOFF MzazON MzazOFF
akxzc	MzzgON MzzgOFF
akxzk	MzzgON MzzgOFF MzzgON MzzgOFF
akxab	MzzgON MzaaON MzazON MzzgOFF MzazOFF MzaaOFF MzazON MzazOFF MzzgON MzaaON MzzgOFF MzaaOFF MzaaON MzaaOFF
akxac	MzaaON MzaaOFF MzaaON MzaaOFF
akxad	MzaaON MzaaOFF MzaaON MzaaOFF
akxae	MzaaON
akxag	MzaaOFF MzaaON MzazON MzzgON MzaaOFF MzazOFF MzzgOFF MzzgON MzazON MzazOFF MzzgOFF MzzgON MzzgOFF
akxak	MzzgON MzzgOFF MzzgON
akxbz	MzzgOFF MzzgON MzzgOFF
akxba	MzzgON MzzgOFF MzzgON MzazON MzzgOFF MzazOFF
akxbc	MzzgON MzzgOFF MzzgON MzaaON MzaaOFF MzzgOFF
akxbg	MzzgON MzazON
akxbh	MzazOFF MzzgOFF
akxbk	MzazON MzazON MzazOFF MzzgON MzazOFF MzzgOFF
akxca	MzzgON MzzgOFF MzzgON MzzgOFF MzzgON MzzgOFF MzzgON
akxcb	MzzgON MzzgOFF MzzgOFF MzzgON MzzgON MzzgOFF MzzgON MzzgOFF
akxcc	MzazON MzazOFF MzazON MzazOFF MzzgON MzzgOFF
akxce	MzzgON MzzgOFF
akxch	MzzgON MzzgOFF
akxci	MzzgON MzzgOFF MzazON MzazOFF MzzgON MzzgOFF
akxdz	MzzgON MzzgOFF
akxdb	MzazON MzazOFF
akxdg	MzzgON MzzeON MzzeOFF MzzgOFF MzzgON MzzgOFF
akxdh	MzzgON MzzgOFF MzzgON MzzgOFF
akxdi	MzzgON MzzeON MzzeOFF MzzgOFF
akxdk	MzazON MzazOFF MzzgON MzzgOFF
akxed	MzzgON MzzgOFF MzzgON MzzgON MzzgOFF
akxeg	MzazON MzazOFF MzazON MzazOFF MzazON MzazOFF
akxeh	MzzgON MzzgOFF
akxei	MzzgON MzaaON MzazON MzaaOFF MzzhON MzazOFF MzzgOFF MzziON MzzkON MzzhOFF MzaeON MzziOFF MzagON MzzkOFF MzahON MzaiON MzagOFF MzaeOFF MzaiOFF MzahOFF MzahON MzaiON MzaiOFF MzahOFF MzahON MzahOFF
akxek	MzahON MzahOFF MzahON MzahOFF MzagON MzagOFF
bzxzz	MzahON MzahOFF MzahON MzahOFF MzahON MzaiON MzaiOFF MzaiON MzaiOFF MzahOFF MzagON MzagOFF MzagON MzaeON MzziON MzagOFF MzzhON MzaeOFF MzzgON MzzhOFF MzzgOFF MzziOFF MzzgON MzzgOFF
bzxzc	MzazON MzaaON MzzgON MzaaOFF MzzhON MzziON MzzgOFF MzzkON MzazOFF MzzhOFF MzaeON MzagON MzzkOFF MzziOFF MzaeOFF MzagON MzagOFF MzagOFF MzagON MzaeON MzaeOFF MzagOFF MzagON MzaeON MzziON MzzkON MzagOFF MzaeOFF MzziON MzadON MzziOFF MzzkOFF MzadOFF MzacON MzadON
bzxzd	MzadOFF MzacOFF MzacON MzacOFF MzacON MzacOFF MzacON MzadON MzacOFF
bzxze	MzaeON MzagON MzadOFF MzaeOFF MzagOFF MzagON MzaeON MzagOFF MzzkON MzaeOFF MzzkOFF MzzkON MzzkOFF MzzkON MzzkOFF MzzkON MzzkOFF MzzkON MzaeON MzagON MzzkOFF
bzxzg	MzziON MzzhON MzaeOFF MzagOFF MzziOFF MzzhON MzzhOFF
bzxzh	MzzkON MzzkOFF MzzkON MzzkOFF MzzkON MzzkOFF MzzkON MzzkOFF
bzxzi	MzzkON MzzhON MzzkOFF MzziON MzaeON MzzhOFF MzagON MzziOFF MzaeOFF MzagOFF MzagON MzagOFF MzagON MzagOFF
bzxzk	MzagON MzagOFF MzagON MzagOFF MzagON MzagOFF MzagON MzagOFF MzagON MzagOFF MzahON MzahOFF MzagON MzagOFF MzagON MzagOFF
bzxaz	MzagON MzaeON MzziON MzzhON MzagOFF MzaeOFF MzzhOFF MzaaON MzazON MzziOFF MzaaOFF MzazOFF MzazON MzazOFF MzazON MzazOFF
bzxab	MzazON MzzgON MzzhON MzazOFF MzziON MzzkON MzzgOFF MzaeON MzzhOFF MzzkOFF MzziOFF MzagON MzaeOFF MzagOFF MzagON MzagOFF MzagON MzagOFF MzagON MzagOFF	
bzxac	MzagON MzagOFF MzaeON MzagON MzaeOFF MzagOFF MzagON MzagOFF MzagON MzagOFF MzagON MzagOFF MzagON MzaeON MzziON MzzhON MzagOFF MzzgON MzaeOFF MzzhOFF MzziOFF MzzgOFF
bzxah	MzazON MzzgON MzazOFF MzzhON MzziON MzzgOFF MzzhOFF MzziOFF MzziON MzaeON MzagON MzziOFF MzaeOFF MzagOFF MzagON MzagOFF MzagON MzagOFF MzagON MzagOFF MzagON MzagOFF
bzxai	MzagON MzagOFF MzagON MzaeON MzziON MzzkON MzagOFF MzzhON MzzkOFF MzzgON MzzhOFF MzaeOFF MzziOFF MzzgOFF MzzgON MzzgOFF
bzxak	MzazON MzazOFF MzazON MzaaON MzzgON MzaaOFF MzzhON MzziON MzazOFF MzaeON MzagON MzzgOFF MzzhOFF MzziOFF MzaeOFF MzagOFF
bzxbz	MzagON MzagOFF MzagON MzagOFF MzagON MzagOFF MzagON MzahON MzagOFF MzagON MzahOFF MzagOFF MzagON MzagOFF
bzxba	MzagON MzahON MzagOFF MzahOFF MzaeON MzagON MzziON MzzkON MzzhON MzzkOFF MzzgON MzaeOFF MzzhOFF MzagOFF MzazON MzziOFF MzzgOFF MzazOFF MzazON MzzgON MzazOFF MzzgOFF MzazON MzzgON MzzgOFF MzazOFF MzazON MzazOFF MzazON MzazOFF	
bzxbb	MzazON MzazOFF MzazON MzazOFF MzazON MzazOFF MzazON MzazOFF MzazON MzazOFF MzazON MzazOFF MzazON MzazOFF MzazON MzazOFF
bzxbc	MzazON MzzgON MzazOFF MzazON MzzgOFF MzazOFF MzazON MzazOFF MzazON MzazOFF
bzxbd	MzazON MzazOFF MzazON MzazOFF MzazON MzazOFF MzazON MzazOFF
bzxbe	MzazON MzazOFF MzazON MzazOFF MzazON MzazOFF MzazON MzazOFF MzazON MzazOFF MzazON
bzxbg	MzazOFF MzazON MzazOFF MzazON MzzgON MzazOFF MzzhON MzziON MzzkON MzaeON MzagON MzzgON MzzkOFF MzziOFF MzahON MzzhOFF MzzgOFF MzagOFF MzaeOFF MzagON MzaeON MzziON MzzkON MzzhON MzahOFF MzzgON MzzkOFF MzaeOFF MzzhOFF MzazON MzagOFF MzziOFF MzazOFF MzazON MzazOFF MzazON MzzgOFF MzazOFF
bzxbh	MzzgON MzzgOFF
bzxbi	MzazON MzazOFF MzzgON MzzgOFF MzzgON MzzgOFF MzzgON
bzxbk	MzzgOFF MzazON MzazOFF MzazON MzazOFF MzazON MzazOFF MzazON MzazOFF
bzxcz	MzzgON MzzgOFF MzzgON MzazON MzzgOFF MzazOFF MzazON MzazOFF
bzxca	MzazON MzazOFF MzazON MzazOFF MzazON MzazOFF MzazON MzazOFF MzazON MzazOFF
bzxcb	MzazON MzazOFF MzazON MzazOFF
bzxcc	MzazON MzazOFF MzazON MzazOFF
bzxcd	MzazON MzzgON MzzgOFF MzazOFF MzzgON MzzgOFF MzazON MzzgON MzazOFF MzzgOFF MzzgON MzzgOFF MzzgON MzzgOFF MzzgON MzzgOFF MzzgON MzzgOFF	
bzxce	MzazON MzzgON MzazOFF MzzgOFF MzzgON MzzgOFF MzzgON MzzgOFF MzzgON MzzgOFF MzazON MzazOFF MzazON MzazOFF
bzxcg	MzazON MzzgON MzzgOFF MzazOFF MzazON MzazOFF MzazON MzazOFF MzazON MzazOFF
bzxch	MzazON MzazOFF
bzxci	MzazON MzazOFF
bzxck	MzazON MzazOFF
bzxdz	MzzgON MzazON MzazOFF MzazON MzzgOFF MzazOFF MzazON MzazOFF MzzgON MzzgOFF MzazON MzazOFF MzazON MzazOFF
bzxda	MzazON MzazOFF MzazON MzazOFF MzazON MzazOFF MzazON MzazOFF MzazON MzazOFF
bzxdb	MzazON MzazOFF MzazON MzazOFF MzazON MzazOFF MzazON MzazOFF
bzxdc	MzazON MzazOFF MzazON MzaaON MzazON MzaaOFF MzazOFF MzazOFF
bzxdd	MzazON MzazOFF
bzxde	MzazON
bzxdg	MzazON MzazOFF MzazOFF MzazON MzazOFF MzazON MzazOFF MzazON MzazOFF
bzxdk	MzazON MzazOFF
bzxez	MzazON MzazOFF MzazON MzazOFF
bzxeb	MzazON MzazOFF MzazON MzazOFF MzazON MzazOFF MzazON MzazOFF
bzxec	MzzgON MzzgOFF MzazON MzazOFF
bzxee	MzazON MzazOFF MzaaON MzazON MzazOFF MzaaOFF MzaaON MzaaOFF MzaaON MzazON MzazOFF MzaaOFF MzazON MzazOFF MzaaON MzaaOFF
bzxeg	MzazON MzazOFF
bzxeh	MzazON MzaaON MzazOFF MzaaOFF
bzxei	MzazON MzazOFF
baxza	MzazON MzaaON MzazOFF MzaaOFF
baxzh	MzaaON MzaaOFF
baxaz	MzaaON
baxaa	MzaaOFF
baxab	MzazON MzazOFF	
baxad	MzazON MzazOFF	
baxae	MzazON MzazOFF	
baxag	MzaaON
baxah	MzaaOFF MzaaON
baxai	MzaaOFF MzazON MzazOFF MzazON MzazOFF MzaaON MzaaOFF
baxba	MzazON MzazOFF
baxbb	MzaaON MzaaOFF MzaaON MzaaOFF
baxbc	MzzgON MzzgOFF MzazON MzazOFF MzzeON MzzgON MzzgOFF
baxbd	MzzeOFF MzaaON MzzgON MzazON MzaaOFF MzazOFF MzzgOFF MzazON MzzgON MzzgOFF MzazOFF MzazON MzazOFF MzzgON MzazON MzzgOFF MzazOFF	
baxce	MzazON MzazOFF	
baxch	MzazON MzazOFF	
baxda	MzazON MzazOFF	
bbxzz	MzzgON MzazON MzzgOFF MzzgON MzazOFF MzazON MzzgOFF MzzgON MzazOFF MzazON MzzgOFF MzzgON MzzgOFF MzazOFF
bbxza	MzazON MzazOFF
bbxzi	MzazON MzazOFF	
bbxaa	MzzgON MzzgOFF
bbxac	MzzgON MzazON MzzgOFF MzazOFF
bbxad	MzazON MzazOFF
bbxae	MzazON
bbxag	MzazOFF MzazON MzzeON MzzgON MzzeOFF MzzgOFF MzazOFF MzzgON MzzgOFF
bbxah	MzazON MzazOFF	
bbxai	MzazON MzazOFF MzazON MzazOFF MzazON MzazOFF MzazON MzazOFF MzazON MzazOFF MzazON MzazOFF MzazON MzazOFF
bbxbb	MzzgON MzzgOFF
bbxbc	MzzgON MzzgOFF MzzgON MzazON MzzgOFF MzazON MzazOFF
bbxbd	MzzgON MzzgOFF MzzgON MzzgOFF
bbxbe	MzazON MzzgON MzazOFF MzazON MzzgOFF MzazOFF
bbxbg	MzzgON MzazON MzzgOFF MzzgON MzazON MzazOFF MzzgOFF MzazOFF MzazON MzazOFF MzazON
bbxbh	MzazOFF MzazON MzazOFF
bbxcz	MzzgON MzazON MzzhON MzazOFF MzzaON MzbcON MzzgOFF MzbbON MzzhOFF MzbcOFF MzbaON MzzaOFF MzbdON MzbeON MzbbOFF MzbgON MzbaOFF MzbdOFF MzbeOFF MzbgON MzbgOFF MzbhON MzbgOFF
bbxca	MzbhOFF MzbhON MzbiON MzbkON MzchON MzbiOFF MzbhOFF MzbkOFF MzchOFF
bbxcb	MzchON MzbkON MzczON MzchOFF MzcgON MzcaON MzbkOFF MzczOFF MzcgON MzcgOFF MzcgOFF MzcaOFF MzcaON MzcgON MzceON MzcbON MzcaOFF MzccON MzcdON MzcgOFF MzcgON MzccOFF MzcgOFF MzcbOFF MzcbON MzcdON MzcbOFF MzccON MzcdOFF MzcbON MzccOFF MzceOFF 
bbxcc	MzceON MzccON MzcdON MzccOFF MzcdOFF MzcbOFF MzcdON MzcdOFF MzcdON MzccON MzcbON MzcdOFF MzccOFF MzcbOFF MzcbON MzcdON MzcbOFF MzcdOFF MzcdON MzcbON MzcdOFF MzcaON MzcaOFF MzcgON MzcgOFF MzceOFF MzcbOFF MzcbON MzcaON MzcaON MzcgON MzcgOFF MzcaOFF MzceON MzceOFF MzcbOFF MzcbON MzceON MzcdON MzcbON MzcbOFF MzcbON MzccON MzccOFF MzcbOFF	
bbxcd	MzcdOFF MzceOFF MzcbON MzceON MzccON MzcdON MzccON MzccOFF MzcbOFF MzccON MzceOFF MzcdOFF MzccOFF MzceON MzccON MzccOFF MzceOFF MzceON MzcdON MzcbON MzcbOFF MzcbON MzcdOFF MzcaON MzcgON MzcgOFF MzcbOFF MzcgON MzceOFF MzcgOFF MzcgON MzcgON MzcgOFF MzcgOFF MzcgON MzcgON MzcaOFF MzcgOFF MzcgON MzcaON MzczON MzcaOFF MzbkON MzcgOFF MzbiON MzczOFF MzbhON MzbkOFF MzbiOFF MzbhON MzbhOFF
bbxce	MzbhON MzbhOFF MzbhON MzbhOFF MzbgON MzbeON MzbdON MzbgOFF MzbaON MzbeOFF MzbbON MzbdOFF MzbcON MzbaOFF MzzaON MzbbOFF MzbcOFF MzzaOFF MzzaON MzbcON MzziON MzzhON MzbcON MzzhOFF MzaeON MzbcOFF MzagON MzziOFF MzahON MzagOFF MzzaOFF MzaeOFF MzaiON MzakON MzahOFF MzbaON MzaiOFF MzbdON MzbeON MzakOFF MzbgON MzbaOFF MzbeOFF MzbdOFF MzbhON MzbgOFF MzbiON MzbkON
bbxcg	MzchON MzbhOFF MzbiOFF MzbkOFF MzchOFF MzchON MzbkON MzbiON MzbhON MzchOFF MzbkOFF MzbhOFF MzbgON MzbiOFF MzbeON MzbgOFF MzbdON MzbaON MzbbON MzbeOFF MzbcON MzbdOFF MzzaON MzbaOFF MzzhON MzziON MzbbOFF MzzhOFF MzbcOFF MzzaOFF MzziOFF MzziON
bbxch	MzziOFF MzziON MzzkON MzzkOFF MzziOFF MzziON MzziOFF MzzkON MzziON MzzhON MzzkOFF MzzkON MzzhOFF MzzkOFF MzzhON MzzhOFF MzzkON MzadON MzzkOFF MzziOFF MzacON MzadOFF MzacOFF MzacON MzadON MzacOFF MzziON MzzkON MzzaON MzzkOFF MzbcON MzbbON MzadOFF MzbaON MzbcOFF MzziOFF MzzaOFF MzbdON MzbbOFF MzbaOFF MzbeON MzbeOFF 
bbxci	MzbdOFF
zgxzz	MzceON MzceOFF
zgxzb	MzceON
zgxzc	MzceOFF
zgxzg	MzcdON
zgxzg	MzceON MzcdOFF MzceOFF	
zgxaz	MzceON MzceOFF	
zgxac	MzceON MzceOFF
zgxad	MzceON MzcdON MzcdOFF MzcdON MzcdOFF MzcdON MzcdOFF MzceOFF	
zgxae	MzceON MzcdON MzceOFF MzcdOFF MzceON MzceOFF
zgxbh	MzceON MzceOFF	
zgxbi	MzceON MzcdON MzcdOFF MzceOFF	
zgxcb	MzceON MzceOFF
zgxck	MzceON MzceOFF MzceON MzcdON MzcdOFF MzcdON MzcdOFF MzceOFF MzcdON MzcdOFF
zgxez	MzceON MzcdON MzcdON MzceOFF MzceON MzccON MzcbON MzcaON MzcgON MzczON MzccOFF MzcbOFF MzceOFF MzcdOFF MzczOFF MzcgOFF MzcaOFF MzcaON MzcgON MzczON MzcbON MzczOFF MzceON MzccON MzcdON MzcgOFF MzcaOFF MzccOFF MzccON MzcbOFF MzccOFF MzcdOFF MzcdON MzcdOFF MzcdON MzceOFF MzceON MzcdOFF MzceOFF MzceON MzceOFF MzceON
zgxea	MzceOFF MzceON MzcdON MzcdOFF MzceOFF MzceON MzceOFF
zgxeg	MzceON MzceOFF MzceON MzceOFF MzceON MzceOFF MzceON MzceOFF MzceON MzceOFF	
zhxza	MzceON MzceOFF
zhxzg	MzceON MzceOFF MzceON MzcdON MzcdOFF MzceOFF MzceON MzceON MzceOFF
zhxdh	MzceON MzceOFF
zhxdi	MzceON MzceOFF MzceON MzceOFF MzceON MzceOFF	
zhxdk	MzcdON MzceON MzcdOFF MzcdON MzcdOFF MzceOFF MzcdON MzceON MzceOFF MzcdOFF MzceON MzcdON MzcdOFF MzcdON MzcdOFF MzcdON MzcdOFF MzcdON MzcdOFF MzcdON MzceOFF	
zhxez	MzceON MzcdOFF MzcdON MzcdOFF MzceOFF	
zhxed	MzcdON MzcdOFF
zhxeg	MzceON MzceOFF
zixzd	MzceON MzceOFF MzceON MzcdON MzcdOFF MzceOFF	
zixaa	MzceON MzcdON MzcdOFF MzcdON MzcdOFF MzcdON MzcdOFF MzceON MzcdON MzceOFF MzccON MzccON MzcbON MzccOFF MzcgON MzcaON MzcbOFF MzczON MzbkON MzcaOFF MzchON MzceOFF MzcgOFF MzcdOFF MzczOFF MzbkOFF MzchOFF
zixak	MzchON MzbkON MzczON MzcgON MzcaON MzcbON MzchOFF MzbkOFF MzcgOFF MzczOFF MzcaOFF MzcaON MzceON MzceOFF MzcaOFF MzceON MzcaON MzceOFF MzcaOFF MzcbOFF MzcaON MzcbON MzcaOFF MzcaON MzcaOFF MzceON MzceON MzceOFF MzcgON MzcaON MzcbOFF MzcgOFF MzcgON MzcaOFF MzcaON MzcaON MzcgOFF MzcgON	
zixbz	MzcaOFF MzcaON MzcaOFF MzcaON MzcgOFF MzcaOFF MzcaON MzcaOFF MzcaON MzcaOFF MzcaON MzcgON MzceON MzcbON MzcdON MzcaOFF MzccON MzcbOFF MzcgOFF MzccOFF MzceOFF MzcdOFF MzcdON MzceON MzcbON MzcdOFF MzceOFF MzcbOFF MzceON MzcbON	
zixba	MzceOFF MzceON MzcdON MzcbOFF MzceOFF MzceON MzceOFF MzcdOFF MzcdON MzccON MzccOFF MzcdOFF MzcdON MzcdOFF MzcdON MzceON MzceON MzceOFF MzccON MzceOFF MzccOFF MzceON MzccON MzceOFF MzceON MzccOFF MzccON MzccOFF	
zixbb	MzcgON MzcdOFF MzcgON MzceOFF MzcgOFF MzceON MzcdON MzcdOFF MzceOFF MzceON MzcdON MzceOFF MzcdOFF MzceON MzcdON	
zixbc	MzcbON MzcaON MzcdOFF MzcgON MzczON MzcaOFF MzbkON MzchON MzcbOFF MzceOFF MzcgOFF MzczOFF MzbkOFF MzchOFF MzchON MzbkON MzczON MzcgON MzceON MzcbON MzchOFF MzbkOFF MzczOFF MzcgOFF MzceOFF MzcaON MzcgON MzceON MzcaOFF MzcaON MzcgOFF MzceOFF MzcbOFF MzcbON MzceON
zixbd	MzcaOFF MzcaON MzcaOFF MzceOFF MzcbOFF MzcbON MzceON MzceOFF MzcaON MzcgON MzcbOFF MzcgOFF MzcbON MzcaOFF MzcaON MzcaOFF MzcbOFF MzcbON MzcbOFF	
zixbe	MzcbON MzcbOFF MzcbON MzcaON MzcbOFF MzcbON MzcaOFF MzcaON MzcbOFF MzcaOFF MzcaON MzcaOFF MzcaON MzcaOFF MzcaON MzcgON MzczON MzbkON MzcaOFF MzbiON MzczOFF MzcgOFF MzbhON MzbkOFF MzbiOFF MzbhOFF MzbgON MzbeON MzbgOFF MzbdON MzbeOFF	
zixbg	MzbdOFF
aexdc	MzbdON MzbaON MzakON MzaiON MzbaOFF MzahON MzakOFF MzbdOFF MzaiOFF MzaiON MzakON MzbaON MzbdON MzaiOFF MzahOFF MzaiON MzahON MzaiOFF MzakOFF MzbaOFF MzbdOFF MzagON MzahOFF MzahON MzagOFF MzagON MzahOFF MzagOFF MzahON MzagON MzagOFF	
aexdd	MzahON MzahOFF MzahON MzahOFF MzahON MzahOFF MzahON MzagON MzagOFF MzagON MzaeON MzahOFF MzaeOFF MzahON MzahOFF MzahON MzagOFF MzahOFF MzahON MzahOFF
aexde	MzahON MzagON MzahOFF MzagOFF MzagON MzahON MzagOFF MzahOFF MzahON MzagON MzahOFF MzagOFF MzagON MzahON MzagOFF MzagON MzagOFF MzahOFF MzahON	
aexdg	MzahOFF MzahON MzaiON MzakON MzbaON MzahOFF MzbdON MzaiOFF MzbdON MzakOFF MzbdOFF MzbeON MzbaOFF MzbeOFF MzbdOFF
aexdk	MzbdON MzbaON MzakON MzaiON MzbaOFF MzbdON MzakOFF MzahON MzbdOFF MzaiOFF MzaiON MzakON MzahOFF MzahON MzakOFF MzaiOFF
aexez	MzahOFF MzahON MzahOFF MzahON MzahOFF MzahON MzahOFF MzahON MzahOFF MzahON MzahOFF MzahON MzahOFF MzahON MzahOFF MzahON MzahOFF MzahON MzahOFF MzahON	
aexea	MzahOFF MzahON MzahON MzahOFF MzahOFF MzahON MzahOFF MzahON MzahOFF MzahON MzahOFF MzahON MzahOFF MzahON MzaiON MzakON MzbaON MzahOFF MzaiOFF MzbaOFF MzbaON MzbdON MzbeON MzakOFF MzbaOFF MzbeOFF MzbdOFF
agxzd	MzbdON MzbeON MzbaON MzbeOFF MzbbON MzbdOFF MzbcON MzbaOFF MzzaON MzbbOFF MzziON MzzhON MzbcOFF MzzaOFF MzziOFF MzzgON MzzhOFF MzazON MzzgOFF MzazOFF
agxze	MzazON MzazON MzazOFF MzzgON MzazON MzzeON MzzgOFF MzzeOFF MzazOFF MzazON MzazOFF MzazON MzazOFF
agxzg	MzazON MzazOFF MzazON MzazOFF MzazON MzazOFF MzazON MzazOFF
agxzk	MzazON MzazOFF MzazON MzazOFF	
agxaa	MzazON MzazOFF MzazON MzazOFF MzazON MzazOFF
agxae	MzazON MzazON MzazOFF
agxbz	MzazON MzazOFF
agxbb	MzazON MzazOFF	
agxbc	MzzhON MzzhOFF MzzhON MzzhOFF MzazON MzazOFF
agxbd	MzzgON MzzgOFF
agxcb	MzazON MzazOFF	
agxcc	MzazON MzazOFF
agxci	MzazON MzazOFF
agxdz	MzazON MzazOFF	
agxda	MzazON MzazOFF	
agxdc	MzazON MzazOFF MzazON MzazOFF MzzkON MzzkOFF MzzkON MzzkOFF MzazON MzazOFF MzazON
agxdd	MzazOFF MzzhON MzzhOFF
agxde	MzazON MzazOFF
agxed	MzzgON MzzgOFF
ahxzd	MzazON MzazOFF MzazON MzazOFF MzazON MzazOFF MzzgON MzzgOFF MzazON MzazOFF MzzkON MzazON MzzkOFF MzzgON MzzgOFF MzazOFF MzzgON MzzgOFF MzzgON MzzeON MzazON MzzeOFF MzzkON MzzgOFF
ahxze	MzzkOFF MzzkON MzazOFF MzzkOFF MzzgON MzazON MzzgOFF MzzkON MzazOFF MzzkOFF MzzeON MzzeOFF MzzgON MzzgOFF
ahxaa	MzazON MzazOFF	
ahxbb	MzzkON MzzkOFF	
ahxbg	MzazON MzazOFF
ahxbh	MzzkON MzzkOFF	
ahxcc	MzzgON MzzgOFF
ahxda	MzazON MzazOFF
ahxdd	MzzgON MzzgOFF MzzeON MzzeOFF MzaaON MzazON MzzkON MzazOFF MzzkOFF MzazON MzaaOFF MzazOFF MzazON MzazOFF
ahxdg	MzazON MzzkON MzazOFF MzazON MzzkOFF MzazOFF MzazON MzzkON MzazON MzzkOFF MzazOFF MzazON MzazOFF MzzgON MzzkON MzzgOFF MzzkON MzazON MzazOFF MzzkOFF
aixzk	MzazON MzazOFF	
aixbz	MzazON MzazOFF
aixbc	MzazON MzazOFF MzazON MzazOFF	
aixdd	MzzgON MzzeON MzazON MzzgOFF MzzeOFF MzazOFF MzazON MzazOFF
aixdg	MzazON MzazOFF MzazON MzazOFF
aixez	MzazON MzazOFF MzazON MzazOFF
aixee	MzazON MzazOFF
aixeh	MzazON MzazOFF
aixek	MzazON MzazOFF MzazON MzzkON MzzkOFF MzazOFF	
akxzz	MzazON MzzgON MzzgOFF MzazOFF
akxzb	MzazON MzazOFF MzazON MzazOFF
akxzc	MzazON MzzgON MzazOFF
akxzd	MzazON MzzhON MzazOFF MzziON MzzkON MzzgOFF MzzhOFF MzaeON MzziOFF MzzkOFF MzaeOFF MzaeON MzagON MzahON MzaeOFF MzagOFF MzahOFF MzahON MzahOFF MzahON MzahOFF MzahON MzahOFF
akxze	MzahON MzahOFF MzahON MzahOFF MzahON MzahOFF MzahON MzahOFF MzahON MzagON MzaeON	
akxzg	MzziON MzahOFF MzzhON MzagOFF MzzgON MzaeOFF MzzhOFF MzziOFF MzazON MzazON MzzgOFF MzzhON MzzgON MzazOFF MzziON MzzgOFF MzzhOFF MzzhON MzzgON MzzhOFF MzziOFF MzzgOFF MzzgON MzzgOFF MzzgON MzzgOFF MzzgON MzzgOFF MzzgON MzzgOFF MzzgON MzzgOFF	
akxzh	MzzgON MzzgOFF MzzgON MzzgOFF 
akxzi	MzzgON MzzgOFF MzzgON MzzgOFF MzzgON MzazON MzzgOFF MzazON MzazOFF MzazOFF
akxzk	MzazON MzazOFF MzazON MzzgON MzzgOFF MzazOFF
akxaa	MzazON MzazOFF
akxab	MzazON MzazOFF MzazON MzazOFF
akxac	MzazON MzazOFF MzazON MzazON MzazOFF MzazON MzzgON MzazOFF MzazON MzazOFF MzzgOFF MzazON MzazOFF MzazON
akxad	MzazOFF MzazON MzazOFF
akxae	MzazON MzazOFF MzazON MzazOFF MzazON MzazOFF
akxag	MzazON MzazOFF MzazON MzzgON MzazOFF MzazON MzzgOFF
akxah	MzazOFF
akxai	MzazON MzazOFF MzazON MzazOFF
akxak	MzazON
akxbz	MzazOFF
akxbk	MzazON MzazOFF MzazON MzazOFF
akxch	MzazON MzazOFF	
akxea	MzazON MzazON MzazOFF	
akxeh	MzazON MzazOFF	
akxei	MzazON MzzgON MzzgOFF MzazOFF MzazON MzazOFF
akxek	MzazON MzazOFF
bzxzc	MzazON MzazOFF
bzxac	MzazON MzazOFF MzazON MzazOFF MzazON MzazOFF
bzxai	MzazON MzazOFF
bzxbh	MzazON MzazOFF
bzxdz	MzazON MzazOFF
bzxda	MzazON MzzkON MzzkOFF MzazOFF MzazON MzazOFF MzazON MzazOFF MzazON MzazOFF MzazON MzazOFF	
bzxdd	MzazON MzzkON MzazOFF MzzkOFF	
bzxde	MzazON MzazOFF
bzxdh	MzazON MzazOFF MzazON MzazOFF
bzxec	MzazON MzazOFF MzazON MzzgON MzzhON MzazOFF MzzgOFF MzziON MzzkON MzaeON MzagON MzzhOFF MzziOFF MzzkOFF MzahON MzagOFF MzaeOFF MzahOFF MzagON MzagOFF MzagON MzahON MzagOFF MzahOFF MzahON	
bzxed	MzaeON MzagON MzahOFF MzziON MzzkON MzagOFF MzzhON MzzkOFF MzaeOFF MzzgON MzziOFF MzzhOFF MzzgON MzzgOFF MzzgOFF MzzgON MzzgOFF MzzgON MzzgOFF MzzgON MzzgOFF MzzgON MzzgOFF MzzgON MzzgOFF MzzgON MzzgON MzzgOFF
bzxee	MzzgON MzzgOFF MzzgON MzzgOFF MzzgON MzzgOFF MzzgON MzzgOFF MzzgON MzzgOFF MzzgON MzzgOFF
bzxeg	MzzgON MzzgOFF MzzgON MzzgOFF MzzgON MzzgOFF MzzgON MzzgOFF MzzgON MzzgOFF MzzgON MzzgOFF MzzgON MzzgOFF MzzgON MzzgOFF
bzxeh	MzzgON MzzgOFF MzzgON MzzgOFF MzzgON MzzgOFF MzzgON MzzgOFF MzzgON MzzgOFF MzzgON MzzgOFF MzzgON MzzgOFF
bzxei	MzzgON MzzgOFF MzzgON MzzgOFF MzzgON MzzgOFF MzzgON MzzgOFF MzzgON MzzgOFF MzzgON MzzgOFF
bzxek	MzzgON MzzgOFF	
baxzz	MzzkON MzazON MzazOFF MzzkOFF
baxzb	MzzkON MzzgON MzzkOFF MzzgOFF MzzgON MzzhON MzzgOFF MzziON MzzkON MzaeON
baxzc	MzagON MzzkOFF MzahON MzzhOFF MzziOFF MzagOFF MzaeOFF MzagON MzaeON MzziON MzzkON MzagOFF MzzhON MzzkOFF MzaeOFF MzahOFF MzzgON MzzhOFF MzziOFF MzzgOFF MzzgON MzzhON MzzhOFF MzzgOFF MzzhON MzziON MzaeON MzagON MzzhOFF MzziOFF MzziON MzzkON MzzhON MzzkOFF MzagOFF MzaeOFF MzzgON MzzhOFF MzazON MzziOFF MzzgOFF MzazOFF
baxzd	MzzgON MzzgOFF
baxze	MzzgON MzzgOFF MzzgON MzzgOFF
baxzg	MzzgON MzzgOFF MzzgON MzzgOFF MzazON MzazOFF MzzgON MzzgOFF MzzkON MzzgON MzzgOFF MzazON MzazOFF MzzkOFF MzzkON MzzkOFF
baxzh	MzzkON MzzkOFF
baxzk	MzzkON MzzgON MzzgOFF MzzgON MzzgOFF MzzkOFF MzzgON MzzhON MzzkON MzzgOFF MzzhOFF MzzkOFF MzzkON MzzkOFF
baxaa	MzzkON MzzhON MzzgON MzzhOFF MzzkOFF MzzgOFF MzzhON MzzhOFF MzzkON MzzkOFF MzzkON MzzkOFF
baxac	MzzkON MzzkOFF MzzkON MzzkOFF MzzkON MzzkOFF
baxad	MzzkON MzzkOFF MzzkON MzzkOFF MzzkON MzzkOFF MzzkON MzzhON MzzgON MzzgOFF MzzgON MzzhOFF MzzkOFF MzzhON MzzgOFF MzzgON MzzhOFF MzzgOFF	
baxae	MzzkON MzzkOFF MzzkON MzzkOFF
baxak	MzzhON MzzhOFF
baxbc	MzzhON MzzhOFF	
baxbe	MzzhON MzzhOFF MzzgON MzzgOFF MzzhON
baxbg	MzzkON MzzhOFF MzzkOFF MzzkON MzzkOFF
baxbi	MzzkON MzzkOFF MzzkON MzzkOFF	
baxcz	MzzgON MzzgOFF
baxca	MzzkON MzzkON MzzkOFF MzzkON MzzkOFF MzzhON MzzgON MzzgON MzziON MzzkON MzzgOFF MzaeON MzzhOFF MzagON MzzkOFF MzahON MzziOFF MzagOFF MzahOFF MzahON MzaeOFF MzahOFF MzahON MzaeON MzagON MzziON MzahOFF MzagOFF MzzhON MzzgON MzaeOFF MzazON MzzhOFF MzzkON MzziOFF MzzgOFF MzazOFF MzzkOFF MzazON MzazOFF MzazON MzazOFF
baxcb	MzazON MzazOFF MzazON MzazOFF MzazON MzazOFF
baxcc	MzazON MzazOFF
baxcd	MzazON MzazOFF MzazON MzazOFF
baxce	MzazON MzazOFF 
baxcg	MzazON MzazOFF MzazON MzazOFF	
baxch	MzazON MzazOFF
baxda	MzazON MzazOFF MzazON MzazOFF
baxdb	MzazON MzazOFF MzazON MzazOFF
baxdc	MzazON
baxdd	MzazOFF MzzgON MzazON MzzgOFF MzzhON MzazOFF MzziON MzzkON MzaeON MzagON MzzkOFF MzzhOFF MzziOFF MzahON MzagOFF MzahON MzahOFF MzaeOFF MzagON MzahOFF MzagOFF MzagON MzagOFF MzahON MzagON MzagOFF MzahOFF MzahON MzahOFF MzahON MzagON MzaeON MzziON MzahOFF MzzhON MzagOFF MzaeOFF MzzkON MzzhOFF MzziOFF MzzkOFF
baxde	MzzkON MzzkOFF MzzkON MzzkOFF MzzgON MzzhON MzzgOFF MzzkON MzzgON MzzhOFF MzzhON
baxdg	MzzgOFF MzzhOFF MzzkOFF MzzhON MzzgON MzzgOFF MzzgON MzzgOFF MzzhOFF MzzhON MzzhOFF MzzkON MzzkOFF MzzkON MzzkOFF
baxdh	MzzgON MzzgOFF MzzkON MzzkOFF MzzkON MzzkOFF MzzkON MzzkOFF
baxdk	MzzgON MzzgOFF MzzgON MzazON MzzgOFF MzzkON MzzkOFF MzazOFF MzazON MzazOFF MzazON MzazOFF MzazON MzazOFF MzazON MzazOFF
baxez	MzazON MzazOFF MzazON MzazOFF
baxec	MzazON MzazOFF MzazON MzazOFF
baxeh	MzazON MzazOFF	
baxei	MzazON MzazOFF MzazON MzazOFF
bbxzd	MzazON MzazOFF	
bbxze	MzazON MzazOFF MzazON MzazOFF
bbxzh	MzazON MzazOFF	
bbxaa	MzazON MzazOFF
bbxag	MzazON MzazOFF
bbxbb	MzazON MzazOFF
bbxbi	MzazON MzazOFF
bbxcc	MzazON MzazOFF MzazON MzazOFF
bbxce	MzazON MzazOFF	
bbxch	MzazON
bbxci	MzazOFF MzzgON MzzgOFF MzazON MzazOFF	
bbxdz	MzazON MzazOFF
bbxda	MzzgON MzzgOFF MzzgON MzzgOFF MzazON MzazOFF MzazON MzazOFF MzazON MzazOFF
bbxdc	MzazON MzazOFF
bbxec	MzazON MzazOFF
bbxei	MzazON
bbxek	MzazOFF MzazON MzazOFF	
zgxzh	MzceON MzcdON MzceOFF MzceON MzcdOFF MzcdON MzcdOFF MzceOFF
zgxad	MzceON MzceOFF
zgxae	MzceON MzcdON MzcdOFF MzceOFF	
zgxeb	MzceON
zgxec	MzcdON MzcdOFF MzcdON MzcdOFF MzceOFF MzceON MzceOFF MzceON MzceOFF	
zgxed	MzceON MzcdON MzcdOFF MzceOFF	
zgxek	MzceON MzceOFF MzceON MzcdON
zhxzz	MzcdOFF MzceOFF
zhxzb	MzceON MzceOFF MzceON MzceOFF	
zhxzh	MzcdON MzcdOFF
zhxzi	MzceON MzceOFF
zhxzk	MzceON MzceOFF MzceON MzceOFF
zhxaz	MzceON MzceOFF MzceON MzceOFF	
zhxaa	MzceON MzceON MzceOFF MzcdON MzcdOFF MzcdON MzcdON MzcdOFF MzceOFF
zhxak	MzceON MzceOFF MzceON MzcdON MzcdOFF MzcdON MzcdOFF MzceOFF
zhxbc	MzceON MzceOFF
zhxbe	MzceON MzcdON MzcdOFF MzceOFF MzceON MzcdON MzcdOFF MzceON MzcdON MzcdOFF MzcdON MzcdOFF MzcdON MzcdOFF MzceOFF MzcdON MzceON
zhxbg	MzcdOFF MzceOFF MzceON MzceOFF
zixzz	MzceON MzceOFF MzceON MzceOFF MzceON MzcdON MzcdOFF MzceOFF MzcdON MzcdOFF MzceON MzcdON MzcbON MzcaON MzcdOFF MzccON MzcdON MzcaOFF MzcbOFF MzccOFF MzceOFF MzceON MzcdOFF
zixza	MzcdON MzcdOFF MzceOFF MzceON MzceOFF
zixzd	MzceON MzceOFF MzceON MzceOFF
zixze	MzceON MzcdON MzcdOFF MzceOFF MzceON MzcdON MzcdOFF MzceOFF MzceON MzceOFF MzceON MzceOFF
zixzg	MzceON MzcdON MzcdOFF MzceOFF MzceON MzceOFF
zixbc	MzceON MzceOFF
zixce	MzceON MzceOFF
zixdd	MzceON MzceON MzcdON MzcdOFF MzcdON MzcdOFF MzcdON MzcdOFF MzcdON MzcdOFF MzceOFF
zixee	MzceON MzceOFF	
zkxzz	MzceON MzcdON MzcdOFF MzcdON MzcdOFF MzcdON MzcdOFF MzcdON MzcdOFF MzceOFF MzceON MzcdON MzcdOFF MzceOFF MzceON MzcdON MzcdOFF MzceOFF	 
zkxza	MzceON MzceOFF
zkxzb	MzceON MzceON MzceOFF
zkxze	MzceON MzcdON MzcdOFF MzcdON MzcdOFF MzceOFF	
zkxzi	MzceON
zkxzk	MzceOFF
zkxaz	MzceON MzcdON MzcdOFF MzceOFF MzceON	
zkxaa	MzcdON MzcdOFF MzcdON MzcdOFF MzceOFF MzceON MzceOFF MzceON MzceOFF MzceON MzceOFF 
zkxeh	MzceON MzceOFF
zkxei	MzceON MzceOFF
aexab	MzzeON MzzgON MzzeOFF MzzgOFF MzzgON MzzeON MzzgOFF MzzeON MzzgON MzzeOFF MzzgOFF MzzgON
aexac	MzzgOFF MzzgON MzzgOFF MzzgON MzzgOFF	
aexag	MzazON MzazOFF
aexak	MzzeOFF MzazON MzazOFF MzazON MzzkON MzazOFF MzazON MzzkOFF MzzgON MzzhON MzazOFF MzziON MzzkON MzzgOFF MzaeON MzagON MzzhOFF MzzkOFF MzziOFF MzagOFF MzaeOFF MzagON MzagOFF
aexbz	MzagON MzahON MzagOFF MzaiON MzahOFF MzahON MzaiOFF MzahOFF MzahON MzahOFF MzahON MzagON MzaeON MzziON MzzkON MzagOFF MzzhON MzzgON MzaeOFF MzahOFF MzziOFF MzzkOFF MzazON MzaaON MzzhOFF MzazOFF MzzgOFF MzazON MzaaOFF MzazOFF MzazON MzazOFF
aexbb	MzzgON MzazON MzazOFF MzzgOFF MzzgON MzzgOFF MzazON MzzgON MzzgOFF MzazOFF
aexbe	MzazON MzazOFF MzzgON MzazON MzzgOFF MzazOFF MzazON MzazOFF MzazON MzazOFF
aexbg	MzzgON
aexbh	MzazON MzzgOFF MzazOFF MzazON MzazOFF MzzgON MzzgOFF	
aexbi	MzazON MzazOFF MzazON MzazOFF	
aexbk	MzzgON
aexcz	MzzgOFF MzzgON	
aexca	MzzgOFF MzzgON MzzgOFF
aexcb	MzzgON MzzgOFF
aexcc	MzazON MzazOFF MzazON MzazOFF
aexcg	MzazON MzaaON MzaaOFF MzazOFF MzazON MzaaON MzaaOFF MzaaON MzaaOFF MzazOFF
aexci	MzazON MzazOFF MzazON	
aexck	MzazOFF
aexdz	MzazON MzzgON MzzhON MzazOFF MzzkON MzziON MzzgOFF MzzkOFF MzzhOFF MzziOFF MzziON MzzaON MzbcON
aexda	MzbbON MzbaON MzziOFF MzbdON MzbcOFF MzzaOFF MzbeON MzbaOFF MzbbOFF MzbgON MzbdOFF MzbeOFF MzbhON MzbiON MzbgOFF MzbkON MzchON MzbiOFF MzbhOFF MzbkOFF MzchON MzchOFF	
aexdb	MzchON MzbkON MzbiON MzchOFF MzbhON MzbkOFF MzbkON MzczON MzcgON MzbiOFF MzcaON MzbhOFF MzbkOFF MzczOFF MzcgOFF MzcgON MzcgOFF MzcaOFF MzcaON MzcgON MzczON MzbkON MzcaOFF MzbiON MzbhON MzcgOFF MzczOFF MzbkOFF MzbgON MzbiOFF MzbhOFF MzbeON MzbdON MzbgOFF MzbaON MzakON MzbeOFF MzaiON MzbdOFF MzahON MzbaOFF MzakOFF MzaiOFF	
aexdc	MzagON MzadON MzaeON MzahOFF MzagOFF MzaeOFF MzadOFF MzadON MzadOFF MzadON MzadOFF MzadON
aexdd	MzadOFF MzadON MzagON MzaeON MzagOFF MzadOFF MzaeOFF MzagON MzaeON MzziON MzagOFF MzzkON MzzkOFF MzzgON MzzhON MzaeOFF MzzhOFF MzziOFF MzaaON MzazON MzaaOFF MzzgOFF MzazOFF MzaaON MzaaOFF MzazON MzazOFF
aexde	MzzgON MzzgOFF
aexdh	MzazON MzzgON MzazOFF MzzgOFF MzazON MzazOFF
aexdi	MzzgON MzzgON MzzgOFF
aexdk	MzzgON MzzgOFF MzzgON MzzgOFF MzzgON MzazON MzzgOFF MzazOFF
aexez	MzazON MzazOFF MzazON MzzgON
aexea	MzzgOFF MzazOFF MzazON MzazOFF MzzgON MzazON MzzgOFF MzzgON MzzgOFF MzazOFF MzzgON MzazON MzazOFF MzzgOFF MzazON MzazOFF MzazON MzazOFF MzazON MzazOFF	
aexeb	MzzgON MzzgOFF MzazON MzzgON MzazOFF MzzgOFF
aexec	MzazON
aexed	MzazOFF MzazON MzzeON MzazOFF MzzeOFF
aexeg	MzazON MzazOFF MzazON MzazOFF MzazON MzzkON MzzgON MzzkOFF MzzgOFF MzazOFF MzzgON MzzgOFF	
aexeh	MzzgON MzzgOFF MzazON MzzkON MzzkOFF MzzkON MzazOFF MzzkOFF
aexei	MzzkON MzzkOFF MzzkON MzzkOFF
agxzd	MzazON MzazOFF
agxzk	MzzkON MzzkOFF MzzkON MzzkOFF
agxaz	MzzgON MzzgOFF
agxaa	MzzkON MzzhON MzzkOFF MzzhOFF MzzhON MzzkON MzzhOFF MzazON MzzkOFF MzazOFF MzzkON MzzkOFF
agxae	MzzkON MzzgON MzzkOFF MzzgOFF MzzgON MzzgOFF
agxag	MzzkON MzzkOFF
agxah	MzzkON MzazON MzzkOFF MzazOFF MzzgON MzazON MzzgOFF MzzgON MzazOFF MzzhON MzziON MzzgOFF MzzkON MzaeON MzagON MzzhOFF MzzkOFF MzziOFF
agxai	MzaeOFF MzagOFF MzagON MzagOFF MzagON MzahON MzahOFF MzagOFF MzahON MzagON MzaeON MzziON MzahOFF MzzkON MzagOFF MzzhON MzzkOFF MzzgON MzaeOFF MzazON MzaaON MzziOFF MzzhOFF MzaaOFF MzzgOFF MzzgON MzazOFF MzazON MzzgOFF MzazOFF MzazON MzazOFF	
agxak	MzazON MzazOFF MzzgON MzzgOFF
agxbz	MzazON MzzgON MzazOFF MzzgOFF
agxba	MzzgON MzzgOFF MzzgON MzzgOFF MzzgON MzzgOFF MzzgON
agxbb	MzzgOFF MzzgON MzazON MzzgOFF MzzgON MzazOFF MzzgOFF MzazON MzazOFF MzazON MzazOFF	
agxbc	MzazON MzazOFF MzzgON MzzgOFF MzazON MzzgON MzzgOFF MzazOFF
agxbd	MzzgON MzzgOFF MzazON MzazOFF MzazON MzazOFF MzzgON MzzgOFF
agxbe	MzazON MzazOFF
agxbh	MzzgON MzazON MzaaON MzzgOFF MzazOFF MzaaOFF MzaaON MzaaOFF
agxbi	MzaaON MzaaOFF
agxbk	MzaaON MzaaOFF MzaaON MzaaOFF MzaaON MzaaOFF MzaaON MzaaOFF
agxce	MzzgON MzazON MzazOFF MzzgOFF MzazON MzzgON MzazOFF MzzgOFF
agxcg	MzzgON
agxch	MzzgOFF MzzgON MzzgOFF MzzgON MzzgOFF MzazON MzaaON MzazOFF MzaaOFF MzazON MzazOFF MzazON MzazON
agxci	MzazOFF MzazON MzazOFF MzaaON MzazON MzaaOFF MzazOFF MzaaON MzzgON MzzgOFF MzazON MzaaOFF MzazOFF MzzgON MzzgOFF MzazON MzzgON MzazOFF MzzgOFF MzazON MzazOFF MzazON MzazOFF MzazON MzazOFF MzzgON
agxck	MzzgOFF MzazON MzazOFF MzazON MzazOFF MzazON MzzgON MzzgOFF MzazOFF MzzgON MzzgOFF MzzgON MzzgOFF MzazON MzazOFF MzzgON MzzgOFF MzazON MzzgON MzzhON MzziON MzzkON MzaeON MzazOFF MzagON MzzgOFF MzzhOFF MzziOFF MzzkOFF MzahON MzaeOFF MzahOFF MzagOFF MzahON
agxdz	MzahOFF MzagON MzagOFF MzagON MzahON MzaeON MzahOFF MzzkON MzziON MzagOFF MzzhON MzzkOFF MzzgON MzaeOFF MzzhOFF MzazON MzziOFF MzazOFF MzzgOFF MzazON MzazOFF MzazON MzazOFF MzazON MzazOFF MzazON MzazOFF
agxda	MzazON MzazOFF MzazON MzazOFF MzazON MzazOFF
agxdb	MzazON MzazOFF MzazON MzazOFF
agxdd	MzazON MzazOFF
agxde	MzazON MzazOFF
agxdi	MzazON MzazOFF MzaaON MzazON MzzgON MzaaOFF MzzgOFF MzazOFF MzzgON MzazON MzaaON MzazOFF MzzgOFF MzaaOFF
agxeb	MzaaON MzazON MzazOFF MzaaOFF
agxec	MzazON MzaaON MzazOFF MzaaOFF MzaaON MzaaOFF
agxed	MzazON MzazOFF MzzgON MzzgOFF MzazON MzazOFF MzazON MzaaON MzaaOFF MzazOFF MzaaON MzaaOFF MzaaON MzaaOFF
agxee	MzaaON MzaaOFF MzaaON MzazON MzaaOFF MzazOFF MzzeON MzzgON MzzeOFF MzzgOFF MzzgON MzzgOFF MzzgON MzzeON MzaaON MzzeOFF MzzgOFF MzaaOFF MzaaON MzaaOFF
agxeg	MzazON MzazOFF MzaaON MzaaOFF
agxeh	MzaaON MzaaOFF
agxei	MzazON MzazOFF
agxek	MzazON MzaaON MzaaOFF MzazOFF MzaaON MzaaOFF MzaaON MzaaOFF
ahxzz	MzaaON MzaaOFF MzaaON MzaaOFF MzaaON MzaaOFF
ahxzc	MzazON MzaaON MzazOFF MzazON MzaaOFF MzazOFF
ahxzd	MzaaON MzaaOFF MzzgON
ahxze	MzzgOFF MzazON MzaaON MzaaOFF MzazOFF MzazON MzazOFF
ahxzg	MzazON MzazOFF MzaaON MzaaOFF MzaaON MzazON MzazOFF MzaaOFF MzaaON MzaaOFF MzaaON MzaaON
ahxzh	MzazON MzazOFF MzaaOFF MzaaON MzaaOFF MzzgON MzzgOFF MzzgON MzzgOFF
ahxzi	MzzgON MzzgOFF MzzgON MzzgOFF
ahxaz	MzazON MzazOFF MzazON MzazOFF MzazON MzzgON MzzeON MzazOFF MzzgOFF MzzeOFF MzzgON MzzhON MzziON MzzkON MzaeON MzzgOFF MzagON MzzkOFF MzzhOFF MzahON MzziOFF MzagOFF MzaeOFF
ahxaa	MzahOFF MzahON MzaiON MzahOFF MzahON MzaiOFF MzaiON MzaiOFF MzaiON MzahOFF MzahON MzahOFF
ahxab	MzahON MzaiOFF MzahOFF MzahON MzahOFF MzahON MzaiON MzaiOFF MzahOFF MzaiON MzaiOFF
ahxac	MzahON MzagON MzaeON MzadON MzahOFF MzacON MzagOFF MzabON MzaeOFF MzadOFF MzaaON MzacOFF MzabOFF MzaaOFF MzaaON MzaaOFF MzaaON MzaaOFF MzaaON MzaaOFF MzaaON MzabON MzacON MzadON MzaaOFF MzabOFF MzaeON MzagON MzahON MzacOFF MzadOFF MzaeOFF MzagOFF MzahOFF
ahxad	MzahON MzahOFF MzahON MzahOFF
ahxae	MzahON MzahOFF
ahxah	MzahON
ahxai	MzahOFF
ahxba	MzahON
ahxbb	MzahOFF
ahxbc	MzaiON MzaiOFF MzaiON MzaiON MzaiOFF MzahON MzahOFF
ahxbd	MzahON MzahOFF MzahON MzahOFF MzahON MzahOFF
ahxbe	MzahON MzahOFF MzahON MzahOFF MzahON MzahON MzahOFF MzahON MzaiON MzahOFF
ahxbg	MzahON MzaiOFF MzaiON MzahOFF MzaiOFF MzaiON MzahON MzahOFF MzaiOFF MzaiON
ahxbh	MzaiOFF MzaiON MzahON MzaiOFF MzagON MzaeON MzadON MzacON MzahOFF MzaeOFF MzabON MzagOFF MzaaON MzadOFF MzabOFF MzacOFF MzabON MzacON MzadON MzabOFF MzziON MzzkON MzacOFF MzzhON MzadOFF MzaaOFF MzzgON MzziOFF MzzkOFF MzzgOFF MzzhOFF MzzhON MzzgON MzzhOFF MzzgON MzzgOFF MzzgOFF MzzhON MzzhOFF MzzhON MzzgON MzziON MzzgOFF MzzkON MzaeON MzagON MzzkOFF MzahON MzziOFF MzzhOFF MzagOFF MzaiON MzaeOFF MzahOFF MzaiOFF MzaiON
ahxbi	MzaiOFF MzaiON MzahON MzaiOFF MzahOFF MzahON MzahOFF MzahON MzagON MzaeON MzziON MzzkON MzzhON MzahOFF MzagOFF MzzgON MzziOFF MzzhOFF MzaeOFF MzzkOFF MzzhON MzziON MzzkON MzaeON MzagON MzziOFF MzzhOFF MzahON MzzkOFF MzzgOFF MzaeOFF MzagOFF MzahOFF MzahON MzaiON MzahON MzaiOFF
ahxbk	MzaiON MzahOFF MzaiOFF MzaiON MzahON MzaiOFF MzahOFF MzahON MzahON MzahOFF
ahxcz	MzaiON MzaiOFF
ahxca	MzahON MzahOFF
ahxcb	MzaiON MzaiOFF MzaiON MzaiOFF MzaiON MzaiOFF	
ahxcd	MzahON MzahOFF MzahON MzahOFF MzahON MzaiON MzaiOFF
ahxce	MzaiON MzaiOFF MzahOFF MzaiON MzaiOFF MzaiON MzaiOFF
ahxch	MzaiON MzahON MzagON MzaeON MzzkON MzaiOFF MzziON MzahOFF MzagOFF
ahxci	MzaeOFF MzzkOFF MzzhON MzzgON MzzhOFF MzazON MzaaON MzzgOFF MzziOFF MzazOFF MzaaOFF MzaaON MzazON MzaaOFF MzaaON MzazOFF MzaaON MzaaOFF MzaaOFF MzazON MzaaON MzaaOFF MzazOFF MzaaON MzaaOFF
ahxck	MzazON MzazOFF MzaaON MzaaOFF MzaaON MzaaOFF MzaaON MzaaOFF MzaaON MzaaOFF MzaaON MzzgON MzzgON MzaaOFF MzazON MzzeON MzazOFF MzzgOFF MzzeON MzzeOFF	
ahxdz	MzzeON MzzgON MzaaON MzazON MzzgOFF MzaaOFF MzzeOFF MzazOFF MzaaON MzazON MzazON MzazOFF MzazOFF MzaaOFF MzaaON MzazON MzaaOFF MzazOFF MzzgON MzzeON MzzeOFF MzzgOFF MzzgON MzzgOFF MzzgON MzzgOFF MzzgON MzzgOFF MzzgON
ahxda	MzzhON MzziON MzzgOFF MzzkON MzaeON MzzkOFF MzagON MzziOFF MzzhOFF MzahON MzaiON MzagOFF MzaeOFF MzahOFF MzaiOFF MzaiON MzaiOFF MzaiON MzahON MzaiOFF MzahOFF MzahON MzahOFF MzagON MzagOFF
ahxdb	MzahON MzagON MzagOFF MzaiON MzahOFF MzahON MzaeON MzagON MzaiOFF MzziON MzahOFF MzzkON MzagOFF MzaeOFF MzzhON MzziON MzzkOFF MzzhOFF MzzhON MzzaON MzzhOFF MzziOFF MzbcON MzzaOFF MzbcOFF MzbcON MzzaON MzzhON MzbcOFF MzzbON MzzcON MzzhOFF MzzaOFF MzzgON MzzbOFF MzzgOFF MzzdON MzzcOFF MzzcON MzzbON MzzaON MzbcON MzzcOFF	
ahxdc	MzzbOFF MzzdOFF MzzaOFF MzbcOFF MzbcON MzzaON MzzhON MzzaOFF MzbcOFF MzzhOFF MzzcON MzzcOFF MzzdON MzzdOFF MzzdON MzzdOFF MzzdON MzzdOFF MzzgON MzzcON MzzgOFF MzzbON MzzhON MzzgON MzzbOFF MzzcOFF MzzgOFF MzzhOFF MzzhON MzzgON MzzaON MzbcON MzzgOFF MzzhOFF MzzaOFF MzbcOFF MzbcON MzzaON MzzhON MzziON MzzaOFF MzzgON MzbcOFF MzziOFF
ahxdd	MzzgOFF MzzgON MzzeON MzzhOFF MzzeOFF MzzeON MzazON MzzeOFF MzazOFF MzazON MzazON MzzhON MzazOFF MzzgOFF MzzgON MzziONMzzgOFF MzzkON MzadON MzzkOFF MzziOFF MzzhOFF MzziON MzadOFF MzadON MzziOFF MzacON MzabON MzadOFF MzaaON MzacOFF MzacON MzaaOFF MzadON MzabOFF MzaeON MzagON MzacOFF MzahON MzadOFF MzaeOFF MzagOFF MzahOFF MzahON MzahOFF MzahON MzaiON MzakON MzbaON MzbdON MzaiOFF MzahOFF MzbeON MzakOFF MzbgON MzbaOFF MzbeOFF MzbdOFF MzbhON MzbiON MzbgOFF MzbkON MzczON MzbiOFF MzbhOFF
ahxde	MzcgON MzbkOFF MzcaON MzcbON MzczOFF MzcaON MzcgOFF MzcaOFF MzcaON MzcaOFF MzcaON MzcaOFF MzceON MzccON MzccOFF MzcgON MzczON MzbkON MzcbOFF MzceOFF MzchON MzcgOFF MzczOFF MzbkOFF MzchOFF MzchON MzchOFF
ahxea	MzchON MzbkON MzczON MzcgON MzcbON MzchOFF MzcaON MzbkOFF MzczOFF MzcgOFF MzcaOFF MzcaON MzceON MzcgON MzcgOFF MzcaOFF MzcaON MzceOFF MzceON MzcaOFF MzcaON MzceOFF MzcaOFF MzcbOFF MzcbON MzcaON MzcbOFF MzcbON	
ahxeb	MzcbOFF MzcbON MzcbOFF MzcbON MzcgON MzczON MzbkON MzchON MzcbOFF MzczOFF MzcgOFF MzcaOFF MzbkOFF MzchOFF MzchON MzbkON MzczON MzcgON MzchOFF MzcaON MzcbON MzbkOFF MzczOFF MzcgOFF MzcaOFF MzcaON MzcaOFF MzcbOFF MzcbON MzcaON MzcbOFF MzcbON MzceON MzcaOFF MzcaON MzceOFF MzccON MzcaOFF MzccOFF MzccON MzcaON
ahxec	MzccOFF MzcbOFF MzcbON MzcaOFF MzceON MzcaON MzcbOFF MzcgON MzceOFF MzcaOFF MzczON MzbkON MzchON MzczOFF MzcgOFF MzbkOFF MzbkON MzczON MzchOFF MzbiON MzczOFF MzbhON MzbkOFF MzbiOFF MzbgON MzbeON MzbhOFF MzbgOFF MzbdON MzbaON MzbeOFF MzbbON MzbcON MzbdOFF MzbaOFF MzzaON MzbbOFF MzzhON MzbcOFF MzzaOFF MzzhOFF MzzhON MzzhOFF MzzhON MzzhOFF MzzhON MzziON
ahxed	MzziOFF MzzhOFF MzzhON MzzgON MzzhOFF MzzgOFF MzzhON MzzhOFF
ahxeg	MzzhON MzziON MzzkON MzzkOFF MzaeON MzzhOFF MzziOFF MzagON MzahON MzaeOFF MzagOFF MzaiON MzahOFF MzakON MzbaON MzbdON MzaiOFF MzbeON MzakOFF MzbaOFF MzbeOFF MzbdOFF
ahxek	MzbdON MzbaON MzakON MzbdOFF MzaiON MzbaOFF MzahON MzakOFF MzaiOFF MzagON MzahOFF MzahON MzagOFF MzaeON MzagON MzziON MzzkON MzzhON MzagOFF MzzkOFF MzaeOFF MzahOFF MzzkON MzziOFF MzzkOFF MzzhOFF MzzkON MzzkOFF MzzkON
aixzz	MzzgON MzzkOFF MzazON MzaaON MzaaOFF MzzgOFF MzazOFF
aixza	MzzgON MzzgOFF
aixzb	MzazON MzazOFF MzazON MzazOFF MzazON MzazOFF MzazON
aixzc	MzazOFF MzaaON MzaaOFF MzzgON MzzgOFF MzazON MzazON MzazOFF MzazON MzazOFF MzazON MzazOFF MzazON MzazOFF
aixzd	MzazON MzazOFF MzzgON
aixze	MzazON MzzgOFF MzazOFF
aixzh	MzzgON MzzgOFF MzzgON MzazON MzzgOFF MzazOFF MzzgON MzzgOFF MzzgON MzzgOFF
aixzi	MzzgON MzazON MzzgOFF MzzgON MzazOFF MzzgOFF MzazON MzzgON MzazOFF MzzgOFF
aixaa	MzzgON MzazON MzzgOFF MzazOFF
aixab	MzazON MzazOFF MzazON MzazOFF MzazON MzazOFF MzaaON MzaaOFF
aixac	MzazON MzazOFF MzazON MzazOFF
aixad	MzazON MzazOFF MzazON MzazOFF MzazON MzazOFF MzazON MzazOFF
aixag	MzazON MzazOFF MzazON MzazOFF MzazON MzazOFF MzazON MzazOFF
aixah	MzazON MzazOFF
aixai	MzazON MzazOFF
aixak	MzazON MzazOFF
aixbz	MzazON MzzeON MzzeOFF MzazOFF MzazON MzazOFF MzazON MzazON MzazOFF MzazON MzzgON MzazOFF
aixba	MzzgOFF MzazON MzzgON MzzgOFF MzazOFF MzzeON MzzeOFF
aixbc	MzzgON MzazON MzzhON MzziON MzzkON MzazOFF MzaeON MzagON MzzhOFF MzziOFF MzzgOFF MzzkOFF MzaeOFF MzagOFF MzahON
aixbd	MzahON MzahOFF MzagON MzaeON MzziON MzzkON MzzhON MzagOFF MzahOFF MzaeOFF MzzgON MzzkOFF MzzhOFF MzziOFF MzazON MzazOFF MzzgOFF MzzgON MzazON MzzgOFF MzzgON MzazOFF MzzgOFF
aixcb	MzazON MzazOFF
aixcg	MzazON MzazOFF
aixci	MzazON MzazOFF MzzeON MzzgON MzzeOFF MzzeON MzzeOFF MzzgOFF
aixck	MzzgON MzzgOFF
aixdz	MzzgON MzzgOFF MzzeON MzzgON MzzeOFF MzzgOFF MzzkON MzzkOFF MzzkON MzzkOFF MzzkON MzzkOFF MzzkON MzzkOFF MzzkON MzzkOFF MzzkON MzzkOFF MzzkON MzzkOFF MzzkON MzziON
aixda	MzzkOFF MzziOFF MzzkON MzzkOFF MzzkON MzzkOFF
aixdc	MzzkON MzzkOFF MzzkON MzzkOFF MzzkON MzzkOFF
aixdd	MzzkON MzzkOFF MzzkON MzzkOFF MzzkON MzzkOFF
aixde	MzzkON MzzkOFF MzzkON MzzkOFF
aixdg	MzzkON MzzkOFF MzzkON MzzkOFF MzzkON MzzkOFF MzzkON MzzkOFF	
aixdh	MzzkON MzzkOFF MzzkON MzzkOFF
aixdi	MzzkON MzzkOFF
aixdk	MzzkON MzzkOFF MzzkON MzzhON MzzgON MzzgON MzziON MzzgOFF MzzaON MzbcON MzzgOFF MzbbON MzzkOFF MzbaON MzzaOFF MzziOFF MzzhOFF MzbdON MzbcOFF MzbeON MzbbOFF MzbaOFF MzbeOFF MzbdOFF
aixea	MzbdON MzbaON MzbbON MzbeON MzbcON MzbeOFF MzzaON MzzhON MzziON MzbaOFF MzbeON MzbbOFF MzbeOFF MzbaON MzbdOFF MzbbON MzbcOFF MzzbON MzzkON MzzaOFF MzbaOFF MzbcON MzzcON MzzkOFF MzbbOFF MzzaON MzzkON MzzhOFF MzzhON MzzbOFF
aixeb	MzzaOFF MzzcOFF MzziOFF MzzcON MzaeON MzzhOFF MzbcOFF MzziON MzzhON MzaeOFF MzadON MzaeON MzzcOFF MzzkOFF MzzkON MzzcON MzziOFF MzzbON MzziON MzadOFF MzzcOFF MzzaON MzaeOFF MzbcON MzzbOFF MzzkOFF MzbbON MzbaON MzbcOFF MzzaOFF MzbdON MzbbOFF MzziON MzbaOFF MzbaON MzaeON MzbbON MzzaON MzbdOFF MzaeOFF MzbaOFF MzbbOFF MzzbON MzzcON MzzaOFF MzzhOFF MzzbOFF MzzaON MzbcON MzzhON MzzcOFF MzbbON MzbaON MzbdON MzzaOFF MzbcOFF MzzkON MzbbOFF MzbbON MzaeON MzbcON MzzaON MzagON MzbaOFF MzbbOFF MzzkOFF MzzaOFF MzadON MzbcOFF MzahON MzzkON MzbdOFF MzzhOFF MzadOFF MzzhON MzaiON MzzkOFF MzakON MzzkON MzaeOFF MzacON MzadON MzagOFF MzzhOFF MzbaON MzbdON MzziOFF MzaiOFF MzbeON MzacOFF MzzkOFF MzahOFF MzbgON MzaeON MzagON MzahON MzakOFF MzacON MzbaOFF MzagOFF MzadOFF MzadON MzbdOFF MzaiON MzaeOFF MzakON MzziON MzbaON MzzaON MzaiOFF MzahOFF MzacOFF MzbdON MzadOFF MzbcON MzbhON MzakOFF MzbbON MzziOFF MzbdOFF MzbaON MzzaOFF MzbaOFF MzbdON MzbcOFF MzbiON MzbeON MzbbOFF MzbgON MzbaOFF MzbeOFF MzbkON MzbdOFF MzbgOFF MzczON MzchON MzbhOFF MzcgON MzbkON MzcgOFF MzbiOFF MzczOFF
aixec	MzbkOFF MzbiON MzbkON MzbiOFF MzbiON MzchOFF MzbkOFF MzbiOFF MzchON MzbkON MzbiON MzbkOFF MzbkON MzchOFF MzchON MzbiOFF MzczON MzczOFF MzczON MzbiON MzczOFF MzczON MzchOFF MzczOFF MzbiOFF MzbiON MzbiOFF MzbiON MzbkOFF MzbkON MzbiOFF MzbiON MzczON MzbiOFF MzchON MzbiON MzczOFF MzchOFF MzbhON MzczON MzbiOFF MzchON MzbiON MzbhON MzbhOFF MzbiOFF MzbiON MzczON MzbiOFF MzbiON MzbkOFF MzczOFF MzchOFF MzchON MzbkON MzbiOFF MzczON MzbiON
aixed	MzczOFF MzchOFF MzbiOFF MzbiON MzbkOFF MzbhON MzbkON MzchON MzbkOFF MzbkON MzchOFF MzbhOFF MzchON MzbhON MzchOFF MzbkOFF MzbgON MzbkON MzchON MzbkOFF MzbeON MzbhOFF MzbdON MzbkON MzczON MzbaON MzbeOFF MzbbON MzbeON MzbdOFF MzbiOFF MzbiON MzbdON MzbcON MzbaOFF MzzaON MzbaON MzbgOFF MzzhON MzbbOFF MzczOFF MzziON MzbhON MzbeOFF MzchOFF MzbcOFF MzzaOFF MzbaON MzbdOFF MzziOFF MzbkOFF MzbdON MzbiOFF MzbgON MzbaOFF MzbeON MzbaON MzbhOFF MzbbON MzzhOFF MzbcON MzzhON MzzaON MzbgOFF MzbcOFF MzzbON MzbcON MzzaON MzakON MzbeOFF
aixee	MzzcON MzaiON MzahON MzziON MzbbOFF MzbaOFF MzagON MzbdOFF MzakOFF MzadON MzaeON MzacON MzabON MzahOFF MzbcOFF MzzaOFF MzaeOFF MzzbON MzaiOFF MzadOFF MzaeON MzagOFF MzagON MzziOFF MzadON MzzbOFF MzzcOFF MzagOFF MzahON MzziON MzacOFF MzaiON MzzcON MzadOFF MzabOFF MzzkON MzakON MzbaON MzahOFF MzzbON MzbbON MzzkOFF MzaeOFF MzzaON MzakOFF MzzgON MzaiOFF MzbbOFF MzzaOFF MzbaOFF MzzkON MzbcON MzbbON MzbaON MzazON MzaaON MzadON MzbdON MzzkOFF MzbeON MzzbOFF MzzhOFF MzaaOFF MzziOFF MzaaON MzbbOFF MzazOFF MzbcOFF MzacON MzakON MzaiON MzazON MzahON MzbdOFF MzbaOFF MzaaOFF MzzcOFF MzagON MzaeON MzakOFF MzzgON MzbeOFF MzzgOFF MzahOFF MzazOFF MzaiOFF MzagOFF MzzgOFF MzzcON MzaeOFF MzziON MzzgON MzazON MzzhON MzzcOFF MzzbON MzazOFF MzzcON MzzkON MzacOFF MzaeON MzzgOFF MzagON MzziOFF MzzhOFF MzzcOFF MzzkOFF MzzcON MzzhON MzzcOFF MzziON MzzbOFF MzzhOFF MzziOFF MzzkON MzziON MzzhON MzahON MzzbON MzzhOFF MzzbOFF MzadOFF MzzcON MzzbON MzzhON MzzaON MzzkOFF MzzkON MzadON MzaeOFF MzagON MzzcOFF MzadOFF MzzaOFF MzzbOFF MzagOFF MzzhOFF MzaeON MzagON MzzkOFF MzzkON MzzhON MzzcON MzzbON MzahOFF MzzkOFF MzzhOFF MzahON MzziOFF MzzaON MzbcON MzbbON MzbaON MzagOFF MzbdON MzbeON MzzcOFF MzagON MzzbOFF MzbcOFF MzbbOFF MzzaOFF MzaeOFF MzakON MzaiON MzagOFF MzbeOFF MzbaOFF MzbdOFF MzagON MzbaON
aixeg	MzbbON MzaiOFF MzbcON MzzaON MzakOFF MzbbOFF MzbaOFF MzzhON MzagON MzaeON MzadON MzagOFF MzzhOFF MzzbON MzbcOFF MzaeOFF MzzbOFF MzzbON MzzhON MzziON MzzcON MzzcOFF MzahOFF MzahON MzzbOFF MzzkON MzadON MzzaOFF MzadOFF MzahON MzaeON MzziOFF MzzkOFF MzaiON MzzhOFF MzagON MzahOFF MzahON MzadOFF MzadON MzaiOFF MzadOFF MzagOFF MzaeOFF MzadON MzaiON MzagON MzaiOFF MzadOFF MzacON MzadON MzahOFF MzagOFF MzagON MzacOFF MzahON MzagOFF MzagON MzaeON MzagOFF MzagON MzziON MzzkON MzahOFF MzzhON MzadOFF MzzkOFF MzahON MzaeOFF MzagOFF MzziOFF MzzhOFF MzzhON MzzhOFF
aixeh	MzzhON MzzhOFF MzzhON MzagON MzagOFF MzagON MzzbON MzzcON MzzdON MzagOFF MzzbOFF MzagON MzzhOFF MzzcOFF MzzcON MzzcOFF MzzcON MzzbON MzaeON MzzdOFF MzzhON MzziON MzzcOFF MzziOFF MzziON MzzbOFF MzzgON MzaeOFF MzziOFF MzagON MzzhOFF MzagON MzagOFF MzagON MzaeON MzzkON MzziON MzzhON MzagOFF MzzkOFF MzaeOFF MzzbON MzahOFF MzzhOFF MzzcON MzziOFF MzzgOFF MzzhON MzzcOFF MzzbOFF MzzgON MzzhOFF MzzgOFF MzzgON MzagON MzagOFF MzzeON MzagON MzzcON MzzbON MzzeOFF MzaeON MzzcOFF MzzkON MzziON MzagOFF MzzgOFF MzaeOFF MzzkOFF
aixei	MzzkON MzziOFF MzaeON MzzkOFF MzagON MzzbOFF MzzbON MzzhON MzaeOFF MzzbOFF MzzbON MzzhOFF MzzhON MzziON MzzbOFF MzagOFF MzziOFF MzzbON MzahON MzziON MzzcON MzziOFF MzzcOFF MzzcON MzagON MzzhOFF MzagOFF MzzcOFF MzzbOFF MzzbON MzahOFF MzahON MzzhON MzagON MzzbOFF MzzbON MzagOFF MzzhOFF MzahOFF MzzhON MzzbOFF MzzhOFF MzzbON MzahON MzzhON MzzhOFF MzagON MzaeON MzzhON MzzbOFF MzahOFF MzaeOFF MzaeON MzzbON MzzhOFF
aixek	MzzbOFF MzaeOFF MzzbON MzzhON MzzhOFF MzzbOFF MzzbON MzzbOFF MzzhON MzahON MzzbON MzagOFF MzziON MzzbOFF MzzbON MzahOFF MzzhOFF MzzbOFF MzzbON MzziOFF MzzhON MzziON MzagON MzahON MzaeON MzaeOFF MzziOFF MzzhOFF MzaeON MzzhON MzziON MzzkON MzahOFF MzagON MzzhOFF MzagOFF MzaeOFF MzziOFF MzzkOFF MzziON MzahON MzzkON MzzbOFF MzzhON MzzbON MzzaON MzzkOFF MzzcON MzzaOFF MzziOFF MzzhOFF MzzcOFF MzzhON MzaiON MzziON MzzkON MzzbOFF MzahOFF MzahON MzzbON MzziON MzziOFF MzzhOFF MzzkOFF MzziOFF MzziON MzzhON MzzbOFF MzaiOFF MzahOFF MzahON MzzbON MzzcON MzzkON MzzcOFF
akxzz	MzaeON MzzhOFF MzagON MzziOFF MzzkOFF MzaeOFF MzagOFF MzziON MzzbOFF MzzbON MzzhON MzzhOFF MzzbOFF MzziOFF MzziON MzzhON MzziOFF MzzhOFF MzaiON MzzbON MzaiOFF MzaiON MzzbOFF MzzhON MzziON MzzbON MzaiOFF MzzkON MzzbOFF MzaeON MzagON MzzkOFF MzadON MzziOFF MzzhOFF MzadOFF MzagOFF MzaiON MzaeOFF MzagON MzaeON MzahOFF MzahON MzaiOFF MzahOFF MzaeON MzahON MzaeOFF MzahOFF MzahON MzaeON MzaeOFF
akxza	MzaeON MzaiON MzadON MzaiOFF MzagOFF MzahOFF MzahON MzaeOFF MzaeON MzagON MzahOFF MzahON MzaeON MzahOFF MzagOFF MzaeOFF MzahON MzahOFF MzadON MzadOFF MzahON MzadON MzziON MzacON MzzkON MzzhON MzzkOFF MzahOFF MzahON MzzkON MzadOFF MzacOFF MzaeON MzagON MzzkOFF MzziOFF MzzhOFF MzacON MzahOFF MzacOFF MzaeOFF MzacON MzagOFF MzahON MzagON MzaeON MzahOFF MzzkON MzziON MzagOFF MzzhON MzacOFF MzzkOFF MzaeOFF MzahON MzzhOFF MzziOFF MzzbON MzahOFF
akxzb	MzzhON MzziON MzahON MzzkON MzzbOFF MzacON MzaeON MzadON MzzkOFF MzzhOFF MzagON MzziOFF MzacOFF MzacON MzacOFF MzagOFF MzacON MzaeOFF MzahOFF MzacON MzaeON MzagON MzadOFF MzahON MzagOFF MzaeOFF MzacOFF MzacON MzahOFF MzahON MzadON MzaeON MzahON MzacOFF MzziON MzaeOFF MzzkON MzzhON MzadOFF MzacON MzzkOFF MzahOFF MzzaON MzzaOFF MzadON MzaeON MzzhOFF MzagON MzzhON MzziOFF MzzgON MzacOFF MzagOFF MzzhOFF MzzgOFF MzzgON MzaeOFF MzzgOFF MzzgON MzacON MzzgOFF MzzgON MzacOFF MzacON MzzgOFF MzahON MzacOFF MzzgON MzahOFF MzazON MzziON MzzhON MzazOFF MzzkON MzzgOFF
akxzc	MzacON MzzhOFF MzaeON MzzkOFF MzacOFF MzahON MzziOFF MzaeOFF MzagON MzaeON MzagOFF MzahOFF MzaeOFF MzaeON MzagON MzzkON MzziON MzahON MzzhON MzagOFF MzadOFF MzaeOFF MzzkOFF MzahOFF MzzbON MzahON MzziON MzzkON MzacON MzzbOFF MzaeON MzagON MzzkOFF MzziOFF MzahOFF MzzhOFF MzaeOFF MzadON MzagOFF MzahON MzadOFF MzadON MzagON MzagOFF MzagON MzziON MzagOFF MzzkON MzahOFF MzzhON MzagON MzacON MzadOFF MzzgON MzzkOFF MzacOFF MzacON MzziOFF MzzhOFF MzzgOFF MzahON MzagOFF MzzgON MzagON MzacOFF MzaeON MzzgOFF MzacON MzzgON MzadON MzahOFF MzadOFF MzzhON MzacOFF MzziON MzacON MzzgOFF MzagOFF
akxzd	MzaeOFF MzzhOFF MzadON MzzkON MzadOFF MzzkOFF MzzhON MzzaON MzacOFF MzacON MzzaOFF MzzgON MzzhOFF MzaeON MzzhON MzagON MzzkON MzagOFF MzadON MzacOFF MzzhON MzzgOFF MzzhOFF MzzkOFF MzziOFF MzaeOFF MzadOFF MzaeON MzagON MzahON MzadON MzagOFF MzacON MzadOFF MzadON MzziON MzahOFF MzacOFF MzziOFF MzaeOFF MzacON MzaeON MzahON MzagON MzzkON MzahOFF MzahON MzacOFF MzzkOFF MzagON MzahOFF MzagOFF MzahON MzaiON	 
akxze	MzagON MzahOFF MzziON MzzkON MzaiOFF MzziOFF MzagOFF MzzkOFF MzzkON MzagON MzzkOFF MzahON MzziON MzzkON MzaiON MzagOFF MzagON MzzhON MzadOFF MzzgON MzaeOFF MzziOFF MzzhOFF MzaiOFF MzagOFF MzzkOFF MzaiON MzzgOFF MzzgON MzaiOFF MzagON MzzhON MzahOFF MzziON MzzhOFF MzzgOFF MzaeON MzahON MzadON MzzkON MzadOFF MzadON MzziOFF MzagON MzagOFF MzzkOFF MzagOFF MzaeOFF MzaeON MzagON MzziON MzahOFF MzadOFF MzzkON MzadON MzagOFF MzahON MzadOFF MzahOFF MzzhON MzagON MzzhOFF
akxzg	MzziOFF MzzkOFF MzagOFF MzagON MzagON MzahON MzadON MzziON MzzkON MzahOFF MzzhON MzzkOFF MzzgON MzzhOFF MzadOFF MzziOFF MzahON MzzeON MzzeOFF MzzeON MzahOFF MzzgOFF MzzgON MzzkON MzziON MzzgOFF MzzhON MzzkOFF MzzeOFF MzzgON MzzeON MzazON MzaeOFF MzaaON MzziOFF MzzgOFF MzaeON MzzeOFF MzagOFF MzziON MzazOFF MzaaOFF MzaeOFF MzzgON MzzeON MzzhOFF MzaaON MzazON MzzkON MzzhON MzaaOFF MzaaON MzaaOFF MzaaON MzzhOFF MzzeOFF MzzgOFF MzzeON MzzhON MzaaOFF MzazOFF MzzkOFF MzziON MzaaON MzziOFF MzaaOFF MzzhOFF MzzhON
akxzh	MzziON MzaaON MzaaOFF MzzkON MzaeON MzagON MzzeOFF MzzkOFF MzzeON MzziOFF MzzhOFF MzahON MzaeOFF MzagOFF MzzeOFF MzzeON MzahOFF MzahON MzazON MzahOFF MzazOFF MzazON MzzeOFF MzahON MzazOFF MzagON MzaeON MzzeON MzzgON MzazON MzziON MzzkON MzahOFF MzagOFF MzzgOFF MzzgON MzazOFF MzaeOFF MzzgOFF MzzkOFF MzzhON MzziOFF MzzgON MzzgOFF MzzgON MzzeON MzzgOFF MzazON MzzeOFF MzazOFF MzzeON MzaaON MzziON MzaaOFF MzaaON MzazON MzziOFF MzazOFF MzzeOFF MzaaOFF
akxzi	MzziON MzzkON MzzeON MzaaON MzzhOFF MzziOFF MzzeOFF MzzeON MzzkOFF MzziON MzaaOFF MzzeOFF MzzkON MzziOFF MzazON MzzgON MzzkOFF MzazOFF MzziON MzzeON MzazON MzzgOFF MzzkON MzzgON MzzeOFF MzzgOFF MzzgON MzazOFF MzzkOFF MzziOFF MzazON MzzgOFF MzzgON MzzeON MzzkON MzzkOFF MzzkON MzziON MzzgOFF MzzgON MzzhON MzazOFF MzzkOFF MzzeOFF MzzkON MzzeON MzzkOFF MzzkON MzzeOFF MzzgOFF MzadON MzzhOFF MzziOFF MzzkOFF MzazON MzazOFF MzazON MzazOFF MzzgON MzzkON MzadOFF MzzeON MzadON MzzkOFF MzzhON MzacON MzziON MzzkON MzacOFF MzaeON MzzhOFF MzagON MzzeOFF MzzkOFF MzacON MzziOFF MzzgOFF MzagOFF MzzgON MzacOFF MzzgOFF MzagON MzadOFF MzaeOFF
akxzk	MzagOFF MzagON MzagOFF MzzgON MzzeON MzahON MzahOFF MzahON MzagON MzazON MzzgOFF MzzeOFF MzagOFF MzazOFF MzagON MzagON MzahOFF MzahON MzagOFF MzagON MzaeON MzzeON MzziON MzzkON MzzeOFF MzahOFF MzazON MzzhON MzzkOFF MzazOFF MzagOFF MzagON MzzkON MzzhOFF MzahON MzagOFF MzaeON MzadON MzzkOFF MzziOFF MzadOFF MzadON MzziON MzzkON MzadOFF MzaeOFF MzzeON MzahOFF MzzeOFF MzzhON MzzeON MzzkOFF MzziOFF MzziON MzzkON MzzeOFF MzzgON MzzkOFF MzahON MzzgOFF MzahOFF MzziOFF MzzbON MzzcON MzahON MzzhOFF MzahOFF MzahON MzzbOFF MzzcOFF MzahOFF MzzcON
akxaz	MzzbON MzzeON MzzbOFF MzzeOFF MzzcOFF MzzeON MzzcON MzzeOFF MzzeON MzahON MzzgON MzagON MzazON MzzcON MzaeON MzazOFF MzazON MzzcOFF MzagOFF MzzeOFF MzazOFF MzahOFF MzzgOFF MzaeOFF MzzcON MzzcOFF MzadON MzzeON MzzcON MzadOFF MzzbON MzzeOFF MzzhON MzziON MzaeON MzzeON MzagON MzzbOFF MzzcOFF MzazON MzzeOFF MzzkON MzzhOFF MzazOFF MzzkOFF MzagOFF MzazON MzzkON MzzeON MzziOFF MzzkON MzazOFF MzadON MzzkOFF MzaeOFF MzziON MzzeOFF MzzkON MzaeON MzzkOFF MzadOFF MzagON MzahON MzagOFF MzagON MzaiON MzziOFF MzzeON MzzeOFF MzziON MzahOFF MzaiOFF MzagOFF MzzhON MzagON MzziOFF MzagOFF MzzhOFF MzziON MzagON
akxaa	MzzhON MzziOFF MzzeON MzzhOFF MzzgON MzzhON MzziON MzzeOFF MzzgOFF MzzeON MzziON MzzgON MzziOFF MzzgOFF MzaeOFF MzahON MzzhON MzagOFF MzahOFF MzzeOFF MzzeON MzzhON MzzeON MzzeOFF MzahON MzzeOFF MzzeON MzaiON MzziON MzzeOFF MzahOFF MzzkON MzzkOFF MzzeON MzaiOFF MzazON MzaiON MzzhOFF MzazOFF MzzkON MzzgON MzahON MzzeOFF MzzhON MzzkOFF MzzeON MzzgOFF MzaiOFF MzzkON MzzgON MzziOFF MzahOFF MzzkOFF MzzhOFF MzzgOFF MzziON MzzkON MzahON MzzhON MzahOFF MzzeOFF MzahON MzzeON MzziOFF MzzkOFF MzziON MzahOFF MzziOFF MzzeOFF MzahON
akxab	MzzhOFF MzahON MzzhON MzziON MzahOFF MzahON MzzhOFF MzahOFF MzziOFF MzahON MzahOFF MzziON MzzhON MzahON MzzeON MzzkON MzagON MzaeON MzzkOFF MzziOFF MzzhOFF MzzeON MzaeOFF MzagOFF MzagON MzzeOFF MzzeON MzagOFF MzagON MzahOFF MzahON MzagOFF MzzeOFF MzzeON MzazON MzzeOFF MzazOFF MzaiON MzagON MzaeON MzzeON MzazON MzzeOFF MzagOFF MzahOFF MzazOFF MzaeOFF MzazON MzzkON MzaiOFF MzazOFF MzaiON MzazON MzzeON MzahON MzazOFF MzzeOFF MzzkOFF MzzeON MzziON MzzkON
akxac	MzzeON MzaiOFF MzahOFF MzzeOFF MzzhON MzzeON MzzeOFF MzzkOFF MzazON MzziOFF MzazOFF MzzgON MzagON MzziON MzaeON MzazON MzzgOFF MzazOFF MzazON MzagOFF MzzhOFF MzaeOFF MzziOFF MzazOFF MzaeON MzaeOFF MzaeON MzzeON MzazON MzziON MzzhON MzaeOFF MzazOFF MzaeON MzzeOFF MzzeON MzaeOFF MzaeON MzzgON MzzhOFF MzagON MzziOFF MzzeOFF MzzeON MzziON MzzhON MzzgOFF MzzgON MzagOFF MzzgOFF MzaeOFF MzazON MzzhOFF MzzhON MzazOFF MzzhOFF MzaeON MzzeOFF MzzkON MzzgON MzagON MzzeON MzzkOFF MzazON MzzeOFF MzzgOFF MzziOFF MzagOFF MzzkON MzziON MzzeON MzazOFF MzzkOFF MzazON MzazOFF MzaeON MzzkON MzzkOFF MzzeOFF MzziOFF MzagON MzzeON MzahON MzzeOFF
akxad	MzagOFF MzazON MzaeOFF MzagON MzahOFF MzagOFF MzahON MzahOFF MzazOFF MzagON MzahON MzahOFF MzahON MzagOFF MzzeON MzazON MzagON MzaeON MzazOFF MzzkON MzzgON MzziON MzzhON MzzhOFF MzzgOFF MzziOFF MzagOFF MzzkOFF MzagON MzzeOFF MzzeON MzzeOFF MzahOFF MzzkON MzzeON MzzkOFF MzzeOFF MzagOFF MzzeON MzagON MzzeOFF MzzkON MzaeOFF MzzkOFF MzaeON MzagOFF MzagON MzaeOFF MzagOFF MzaeON MzagON MzzkON MzziON MzagOFF MzzhON MzzkOFF MzagON
akxae	MzzgON MzzkON MzzhOFF MzzkON MzzgOFF MzagOFF MzaeOFF MzagON MzzkOFF MzziOFF MzzeON MzadON MzzeOFF MzaeON MzadOFF MzadON MzziON MzzkON MzadOFF MzazON MzazOFF MzzkOFF MzagOFF MzazON MzagON MzadON MzazOFF MzazON MzahON MzziOFF MzadOFF MzazOFF MzagOFF MzaeOFF MzzeON MzazON MzahOFF MzzkON MzzhON MzahON MzziON MzaeON MzazOFF MzagON MzzkOFF MzzhOFF MzziOFF MzzgON MzaeOFF MzagOFF MzaiON MzzeOFF MzzgOFF MzakON MzagON MzaeON MzadON MzacON MzaiOFF MzakOFF MzadOFF MzagOFF MzaeOFF MzahOFF MzacON MzaiON MzziON MzzkON MzaiOFF MzahON MzagON MzaeON MzzeON MzzhON MzahOFF MzadON MzagOFF MzzeON MzagON MzzeOFF MzadOFF MzzhOFF MzzkOFF MzziOFF MzadON MzacOFF MzacON MzahON
akxag	MzaiON MzziON MzzkON MzacOFF MzzhON MzzkOFF MzzgON MzadOFF MzaeOFF MzaeON MzziOFF MzzhOFF MzziON MzzkON MzahOFF MzagOFF MzzhON MzahON MzaeOFF MzzkOFF MzzeON MzziOFF MzahOFF MzzhOFF MzzhON MzaiOFF MzzgOFF MzzgON MzziON MzazON MzzgOFF MzzgON MzziOFF MzazOFF MzziON MzzgOFF MzzkON MzaeON MzagON MzzkOFF MzziOFF MzahON MzzgON MzzeOFF MzzhOFF MzaeOFF MzagOFF MzzeON MzahOFF MzazON MzahON MzzeOFF MzzgOFF MzazOFF MzahON MzahOFF MzagON MzaeON MzzeON MzziON MzzkON MzagOFF MzagON MzzeOFF MzzkOFF MzziOFF MzziON MzzkON MzagOFF MzahOFF MzzkOFF MzzkON MzaeOFF MzzkOFF MzzkON MzazON MzaeON MzagON MzzgON MzzhON MzahON MzzgON MzzkOFF MzazOFF
akxah	MzzeON MzazON MzzeOFF MzazOFF MzaeOFF MzzeON MzagOFF MzzhOFF MzziOFF MzzhON MzzhOFF MzzhON MzahOFF MzzhOFF MzahON MzzhON MzzeOFF MzaiON MzzhON MzzhOFF MzzhON MzahOFF MzzeON MzzhOFF MzaiOFF MzzeOFF MzzhON MzzgOFF MzzgON MzaiON MzzeON MzahON MzzhOFF MzagON MzzeOFF MzzeON MzzhON MzaeON MzahOFF MzahON MzzeOFF MzaiOFF MzagOFF MzaiON MzzhOFF MzaeOFF MzahOFF MzaiOFF MzzhON MzahON MzzhOFF MzagON MzaeON MzziON MzagOFF MzahOFF MzzhON MzzbON MzaeOFF MzzcON MzziOFF MzzbOFF MzzhOFF MzzcOFF MzzeON MzzhON MzzhOFF MzzeOFF MzzcON
akxai	MzzcOFF MzzcON MzzbON MzzhON MzziON MzzkON MzzbOFF MzzcOFF MzzeON MzzbON MzzkOFF MzzeOFF MzzcON MzzbOFF MzziON MzzkON MzzhOFF MzziOFF MzzkOFF MzzcOFF MzzkON MzzkOFF MzzeON MzzkON MzzeOFF MzzeON MzzeOFF MzzeON MzzkOFF MzzeOFF MzzeON MzzeOFF MzzeON MzzgOFF MzzgON MzzeOFF MzzgON MzzeON MzzgOFF MzzgON MzzeOFF MzzgOFF MzzgON MzzgOFF MzzgON MzzcON MzzhON
akxak	MzzeON MzzhOFF MzzeOFF MzzcOFF MzzeON MzazON MzzgOFF MzzeOFF MzzgON MzazOFF MzzhON MzzhOFF MzzgON MzzhON MzzhON MzzgOFF MzzhOFF MzzgON MzazON MzzgOFF MzzgON MzazOFF MzzhON MzzhOFF MzzhON MzzhOFF MzzhON MzzhOFF MzzhON MzzhOFF MzzhON MzzhOFF MzzeON	
akxbz	MzzeOFF MzzgOFF MzzhON MzzgON MzzhOFF MzzhON MzzhOFF MzzeON MzzeOFF MzzeON MzzeOFF MzzgOFF MzzgON MzzgOFF MzzgON MzzeON MzaaON MzzeOFF MzaaOFF MzzgOFF MzzgON MzzgOFF MzzgON
akxba	MzzgOFF MzzgON MzzgOFF MzzgON MzzgOFF MzzgON MzzgOFF MzzeON MzzgON MzzeOFF MzzgOFF MzzgON MzazON MzazOFF MzaaON MzaaOFF MzzeON MzaaON MzaaOFF MzzeOFF
akxbb	MzzhON MzazON MzzhOFF MzazOFF MzzgOFF MzzhON MzzhOFF MzzgON MzzgOFF MzzgON MzzgOFF MzzgON MzzgOFF MzzgON MzzgOFF MzzgON MzzgOFF MzzgON MzzhON MzzhOFF MzzgOFF MzzhON MzzgON MzzgOFF MzzhON MzzgON MzzgOFF MzzhOFF	
akxbc	MzzgON MzzgOFF MzzgON MzzgOFF MzzgON MzzgON MzzeON MzzgON MzzeOFF MzzgOFF MzzhON MzzgON MzzhOFF MzzgOFF MzzgON MzzgOFF MzzgON MzzhON MzzhOFF MzazON MzzgOFF MzzgON MzazOFF	
akxbd	MzzgON MzzeON MzzgOFF MzzgON MzzdON MzzeOFF MzzcON MzzbON MzzhON MzziON MzzbOFF MzzkON MzzdOFF MzzcOFF MzzhOFF MzzkOFF MzziOFF MzaeON MzagON MzahON MzaeOFF MzagOFF MzaiON MzzgON MzaiOFF MzahOFF MzzgOFF MzzgON MzzgOFF MzzgON MzaiON MzzhON MzahON MzzhOFF MzzhON MzaiOFF MzagON MzzgOFF MzahOFF MzzhOFF MzzgON MzzhON MzzhOFF MzagOFF MzzhON MzzhOFF MzagON MzahON MzagOFF MzzhON
akxbe	MzaiON MzzhOFF MzahOFF MzahON MzzhON MzagON MzaeON MzaiOFF MzahOFF MzziON MzzhOFF MzzhON MzagOFF MzzbON MzzcON MzaeOFF MzzgOFF MzzbOFF MzziOFF MzzhOFF MzzgON MzzcOFF MzzdON MzzdOFF MzzgOFF MzzgON MzzgOFF MzzgON MzzgOFF MzzgON MzzgOFF MzzgON MzzhON MzzgOFF MzzgON MzzhOFF MzzhON MzzgOFF MzzhOFF MzzgON MzzgOFF MzzgON MzzeON MzzeOFF MzzgOFF MzzeON MzzgON MzzgOFF
akxbg	MzzeOFF MzzhON MzzhOFF MzzkON MzzhON MzzeON MzzhOFF MzzgON MzzhON MzzkOFF MzzgOFF MzzeON MzzeOFF MzzgON MzzhOFF MzzgOFF MzzgON MzzhON MzzhOFF MzzgOFF MzzgON MzzgOFFMzzhON MzzhOFF MzzgOFF MzzgON MzzgOFF MzzhON MzzgON MzzhOFF MzzgOFF MzzgON MzzhON MzzhOFF MzzcON MzzgOFF MzzgON MzazON MzzgOFF MzzgON MzzbON MzzhON MzazOFF MzziON MzzkON MzzcOFF MzzbOFF MzagON MzzgOFF MzaeON MzzkOFF MzzhOFF MzziOFF MzahON MzagOFF
akxbh	MzaiON MzaeOFF MzahOFF MzahON MzaiOFF MzzgON MzahOFF MzzgOFF MzazON MzazOFF MzzgON MzzgOFF MzahON MzzgON MzahOFF MzzgOFF MzzgON MzzkON MzzgOFF MzzkOFF MzzkON MzzgON MzzgOFF MzzkOFF MzazON MzzgON MzzgOFF MzazOFF MzahON	
akxbi	MzazON MzazOFF MzzkON MzzkOFF MzahOFF MzahON MzahOFF MzzgOFF MzzgON MzagOFF MzzgOFF MzzgON MzazON MzagON MzzgOFF MzagOFF MzagON MzazOFF MzazON MzazOFF MzazON MzazOFF MzagOFF MzzgON MzagON MzazON MzzeON MzazOFF MzzgOFF	
akxbk	MzaeON MzzeOFF MzziON MzzkON MzagOFF MzazON MzzkOFF MzaeOFF MzzkON MzazOFF MzazON MzzkOFF MzziOFF MzziON MzzkON MzazOFF MzzgON MzzhON MzzhOFF MzzeON MzzhON MzzgOFF MzzeOFF MzzhOFF MzzkOFF MzzhON MzazON MzziOFF MzzbON MzzcON MzzgON MzzbOFF MzzkON MzzeON MzzhOFF MzzcOFF MzzkON MzazOFF MzzgOFF MzzkOFF MzzeOFF MzazON MzzgON MzazOFF MzazON MzzgOFF MzzkON MzzgON MzzeON MzazOFF MzzgOFF MzzeOFF MzazON MzazOFF MzzkOFF MzazON MzazOFF MzzgON MzzeON
akxcz	MzzgOFF MzzkON MzzeOFF MzzkOFF MzzkON MzzkOFF MzzkON MzzkOFF MzzgON MzzgOFF MzzeON MzzgON MzzgOFF MzzeOFF MzzkON MzzkOFF MzzeON MzzeOFF MzazON MzzgON MzzeON MzazOFF MzzeOFF MzzgOFF MzzgON MzazON MzazOFF MzzgOFF MzzeON MzzeOFF	
akxca	MzazON MzazOFF MzzgON MzazON MzzeON MzazOFF MzazON MzzgOFF MzzeOFF MzazOFF MzzgON MzzgOFF MzzgON MzzgOFF MzzgON MzzgOFF MzazON MzazOFF MzazON MzazOFF MzazON MzazOFF MzazON MzazOFF MzzgON MzzgOFF MzzeON MzzgON	
akxcb	MzzeOFF MzzgOFF MzzgON MzzgOFF MzzgON MzzgOFF MzzgON MzzgOFF MzazON MzzgON MzzgOFF MzzgON MzazOFF MzazON MzazOFF MzzgOFF MzazON MzazOFF MzazON MzzgON MzzgOFF MzazOFF MzazON MzazOFF MzzgON MzzgOFF MzzgON MzzkON MzazON MzzgOFF MzazOFF MzzkOFF MzazON MzzgON MzazOFF MzazON MzzgOFF MzzgON MzazOFF
akxcc	MzzgON MzzeON MzzeOFF MzzgON MzzgOFF MzzgON MzzkON MzzkOFF MzzgON MzzgOFF MzzgON MzzeON MzzeOFF MzazON MzazOFF MzzhON MzzgOFF MzzhOFF MzazON MzazOFF MzazON MzazOFF MzazON MzazOFF MzazON MzzeON MzazOFF MzzkON MzzkOFF MzzeOFF MzzeON MzzeOFF
akxcd	MzzeON MzzeOFF MzzeON MzzeOFF MzzeON MzzgON MzzgOFF MzzeOFF MzzeON MzzkON MzzkOFF MzzeOFF MzzeON MzzeOFF MzzgON MzzgOFF MzazON MzazOFF MzzeON MzzkON MzzgON MzzeOFF MzzhON MzzkOFF MzzhOFF MzazON MzzhON MzzeON MzzhOFF MzzeOFF MzzkON MzazOFF MzzkOFF MzazON MzzgOFF MzazOFF
akxce	MzzeON MzzkON MzzkOFF MzzeOFF MzazON MzzeON MzzkON MzazOFF MzazON MzzkOFF MzazOFF MzazON MzzkON MzazOFF MzzeON MzazON MzzkOFF MzazOFF MzazON MzzeOFF MzazOFF MzzeON MzzeOFF MzazON MzzeON MzzgON MzaaON MzazOFF MzzeOFF MzzgOFF MzaaON MzazON MzzeON MzazOFF MzazON MzzeOFF MzazOFF MzaaOFF MzzkON MzzeON MzzgON MzzkOFF MzaaON MzzeOFF MzzgOFF MzaaOFF MzaaON MzaaOFF MzaaON MzzeON MzazON MzzeOFF MzazOFF
akxcg	MzazON MzaaOFF MzzeON MzazOFF MzzgON MzazON MzzeOFF MzzeON MzazOFF MzzgOFF MzzeOFF MzzeON MzzeOFF MzazON MzzgON MzzeON MzaaON MzzgON MzzgOFF MzzgOFF MzazOFF MzzeOFF MzazON MzaaOFF MzazOFF MzaaON MzaaOFF MzaaON MzaaOFF MzaaON MzaaOFF MzaaON MzaaOFF MzzkON MzaaON MzzkOFF MzzeON MzzeOFF MzaaOFF MzazON MzzeON MzzkON MzazOFF MzzkOFF MzzeOFF MzzeON MzazON MzzeOFF MzzeON MzazOFF
akxch	MzzeOFF MzzeON MzzeOFF MzaaON MzzkON MzaaOFF MzzhON MzziON MzaeON MzagON MzzhOFF MzziOFF MzazON MzzkOFF MzahON MzagOFF MzazOFF MzaeOFF MzzgON MzazON MzzgOFF MzahOFF MzahON MzazOFF MzagON MzaeON MzzgON MzziON MzzkON MzzgOFF MzahOFF MzagOFF MzaeOFF MzziOFF MzzkOFF MzzeON MzzkON MzaaON MzaaOFF MzzeON MzzeOFF MzzkOFF MzzeON MzzkON MzziON MzaaON MzziON MzazON MzazOFF MzzkOFF MzzeOFF MzaaOFF MzaeON MzadON MzzeON MzagON MzzeOFF MzadOFF
akxci	MzziOFF MzagON MzzeON MzziON MzzkON MzagOFF MzzgON MzazON MzzhON MzzeOFF MzzkOFF MzaeOFF MzzeON MzzgOFF MzazOFF MzzkON MzzgON MzziOFF MzaaON MzzhOFF MzaaOFF MzzgOFF MzzkOFF MzaaON MzzgON MzazON MzaaOFF MzazOFF MzzkON MzzkOFF MzzeOFF MzzeON MzzgOFF MzzeON MzazON MzazOFF MzzkON MzzgON MzaaON MzazON MzaaOFF MzzgOFF MzazOFF MzzeOFF MzzkOFF MzzkON MzzkOFF MzaaON MzaaOFF
akxck	MzaaON MzaaOFF MzzeON MzzkON MzzeOFF MzzkOFF MzzeON MzzkON MzzeOFF MzzkON MzzkOFF MzzkOFF MzzkON MzzkOFF MzzkON MzzkOFF MzzgON MzzhON MzazON MzzhOFF MzazOFF MzzgOFF MzzgON
akxdz	MzazON MzazON MzazOFF MzaaON MzzgOFF MzaaOFF MzzgON MzzgOFF MzazON MzazOFF MzzgON MzzgOFF MzzgON MzzhON MzzgOFF MzzgON MzzhOFF MzzgOFF MzzeON MzzgON MzzeOFF MzzgOFF MzzhON MzzgON MzzgOFF MzzhOFF	
akxda	MzzkON MzzhON MzzgON MzzgOFF MzzhOFF MzzkOFF MzzgON MzzgOFF MzazON MzazOFF MzazON MzazOFF MzazON MzzeON MzazOFF MzaaON MzaaOFF MzaaON MzzkON MzzeOFF MzzkOFF MzaaOFF MzzeON MzzeOFF MzzeON MzaaON MzazON MzzeOFF MzaaOFF MzazOFF MzaaON MzaaOFF MzzkON MzzkOFF MzaaON MzaaOFF	
akxdb	MzzeON MzzgON MzzkON MzzhON MzzkON MzzkOFF MzzgOFF MzzgON MzzkON MzziON MzzeOFF MzaaON MzazON MzzhOFF MzzeON MzzkOFF MzzkON MzaaOFF MzzgOFF MzzgON MzazOFF MzzgOFF MzaeON MzzkOFF MzagON MzaaON MzziOFF MzzgON MzaaOFF MzzeOFF MzziON MzzgOFF MzagOFF MzzkON MzzhON MzzeON MzaeOFF MzzkOFF MzzhOFF MzzhON MzzgON MzzgON MzzgOFF MzziOFF MzzgOFF MzzhOFF MzzhON MzzeOFF MzzeON MzzhOFF MzzhON MzzhOFF MzzhON MzziON MzzgON MzziOFF MzzkON MzzeOFF MzzhOFF MzzgOFF MzzeON MzzgON MzzkOFF MzzgOFF MzzgON MzzgOFF MzzkON MzzgON
akxdc	MzzgOFF MzzeON MzzgON MzzgOFF MzzkOFF MzzeOFF MzaaON MzazON MzazOFF MzaaOFF MzzgON MzzeON MzzgOFF MzzeOFF MzaaON MzazON MzazOFF MzaaOFF MzzkON MzzkOFF MzzeON
akxdd	MzazON MzazOFF MzzeOFF MzzeON MzaaON MzaaOFF MzzeOFF MzzkON MzzeON MzzeOFF MzzkOFF MzzeON MzzeOFF MzzeON MzzeOFF MzzeON MzaaON MzzeOFF MzaaOFF MzzeON MzzeOFF	
akxde	MzzkON MzzgON MzzhON MzzgOFF MzzhOFF MzzkOFF MzzgON MzazON MzzhON MzzeON MzziON MzzgON MzazOFF MzzkON MzzgOFF MzzeOFF MzzgON MzzeON MzzhOFF MzzkOFF MzziOFF MzziON MzzkON MzzgOFF MzzhON MzzkOFF MzzgON MzzhOFF MzziOFF MzzeOFF MzzhON MzziON MzzgOFF MzziOFF MzziON MzzkON MzzeON MzaeON MzzhOFF MzagON MzziOFF MzzgON MzzkOFF MzziON MzzkON MzzgOFF MzagOFF MzzeOFF MzzhON MzaeOFF MzzkOFF MzzgON MzaaON MzziOFF MzzeON MzzhOFF MzaaOFF MzzgOFF MzzgON MzzcON MzzbON MzzhON MzziON MzzcOFF MzzeOFF MzzbOFF MzzgOFF MzzkON MzzeON MzzhOFF MzaeON MzagON MzzgON MzzkOFF MzazON MzzeOFF MzahON MzazOFF MzziOFF MzazON MzaeOFF MzagOFF MzazOFF MzzgOFF MzazON MzzgON MzahOFF MzazOFF MzazON
akxdg	MzahON MzzgOFF MzazOFF MzazON MzzgON MzazOFF MzzgOFF MzazON MzzgON MzazOFF MzahOFF MzzgOFF MzzkON MzzkOFF MzzkON MzzkOFF MzahON MzahOFF MzahON MzagON MzaeON MzziON MzagOFF MzahOFF MzzkON MzzhON MzaeOFF MzzkOFF MzzgON MzzkON MzzhOFF MzziOFF MzazON MzaaON MzzkOFF MzaaOFF MzzgOFF MzazOFF MzzeON MzazON MzzeON MzazOFF MzaaON MzazON MzzeOFF MzazOFF
akxdh	MzzeON MzazON MzazOFF MzaaOFF MzazON MzzeOFF MzazOFF MzazON MzzeON MzzkON MzzgON MzazOFF MzzkOFF MzzgOFF MzzeOFF MzzgON MzzeON MzazON MzazON MzzgOFF MzzeOFF MzazOFF MzzkON MzzkOFF MzzkON MzzeON MzzkOFF MzzkON MzzeOFF MzzkOFF MzzeON MzzgON
akxdi	MzzgON MzzkON MzzgOFF MzzeOFF MzzkOFF MzzkON MzzhON MzziON MzzaON MzbcON MzbbON MzzkOFF MzziOFF MzziON MzzkON MzbcOFF MzzaOFF MzziOFF MzzhOFF MzbbOFF MzzkOFF MzzkON MzazON MzaaON MzzkON MzazOFF MzaaON MzzeON MzaaOFF MzzkOFF MzazON MzzeOFF MzazOFF MzaaON MzzgON MzzeON MzaaOFF MzzcON MzzbON MzaaON MzzgOFF MzzeOFF MzaaOFF MzaaON MzzaON MzzcOFF MzaaOFF MzaaON MzzhON MzbcON MzzbOFF MzaaOFF MzaaON MzzkON MzzkOFF MzzhOFF MzzhON MzaaOFF MzzaOFF MzzaON MzzhON MzzhOFF MzazON MzzbON MzazOFF
akxdk	MzzhOFF MzzhON MzzbOFF MzzhOFF MzzaOFF MzazON MzbcOFF MzazOFF MzzkON MzzgON MzzaON MzzkOFF MzzkON MzzeON MzazON MzzaOFF MzzcON MzazOFF MzazON MzazOFF MzzeOFF MzzgOFF MzzcOFF MzzkOFF MzzkON MzziON MzzcON MzzbON MzzgON MzazON MzzhON MzbcON MzzaON MzzcOFF MzzbOFF MzzgOFF MzazOFF MzaeON MzzgON MzagON MzazON MzziOFF MzzgOFF MzahON MzzhOFF MzaeOFF MzagOFF MzazOFF MzazON MzahOFF MzbcOFF MzbcON MzbcOFF MzzaON MzazOFF MzzkOFF MzzaOFF MzzkON MzzkOFF MzazON MzahON MzazOFF MzzkON MzagON MzaeON MzzkOFF MzadON	
akxez	MzadOFF MzahOFF MzahON MzzkON MzaeOFF MzagOFF MzagON MzzkOFF MzahOFF MzzkON MzzkOFF MzzkON MzaeON MzadON MzagON MzagOFF MzzkOFF MzadOFF MzadON MzaeOFF MzaeON MzadOFF MzadON MzziON MzzkON MzzhON MzzkON MzzbON MzzkOFF MzzcON MzadOFF MzagON MzzhOFF MzzkON MzagOFF MzaeOFF MzziOFF MzzgON MzziON MzzbOFF MzzeON MzzhON MzzcOFF MzzkOFF MzzhOFF MzaaON MzazON MzzeOFF MzziOFF MzzgOFF MzaaOFF MzazOFF MzzgON MzzeON MzzgOFF MzzgON MzzgOFF MzzeOFF MzazON MzzeON MzazOFF MzzeOFF MzazON MzzeON MzazOFF MzazON	
akxea	MzzeOFF MzzeON MzzgON MzazOFF MzzeOFF MzzgOFF MzzeON MzzeOFF MzzeON MzzeOFF MzzeON MzzeOFF MzzeON MzzeOFF MzzeON MzzkON MzzhON MzziON MzaaON MzzeOFF MzaeON MzzhOFF MzaaOFF MzagON MzzkOFF MzziOFF MzahON MzagOFF MzaaON MzaiON MzazON MzaeOFF MzazOFF MzzeON MzahOFF MzaaOFF MzaiOFF MzaiON MzzeOFF MzzeON MzaiOFF MzzeOFF MzaiON MzahON MzaiOFF MzahOFF MzahON MzzeON MzazON MzazOFF MzazON MzagON	
akxeb	MzaeON MzazOFF MzzeOFF MzziON MzzkON MzazON MzzhON MzagOFF MzzgON MzahOFF MzzeON MzaeOFF MzzgOFF MzzgON MzzkOFF MzazOFF MzziOFF MzzeOFF MzzgOFF MzzkON MzzgON MzzhOFF MzzgOFF MzzkOFF MzazON MzazOFF MzazON MzazOFF MzazON MzazOFF MzzeON MzzeOFF MzazON MzzeON MzzgON MzaaON MzzeOFF MzazOFF MzazON MzzgOFF MzzkON MzazOFF MzzhON MzzeON MzaaOFF MzaaON MzzhOFF MzaaOFF MzazON MzzeOFF MzzeON MzaaON MzazOFF MzzeOFF MzzeON MzzkOFF MzzkON MzaaOFF MzzeOFF	
akxec	MzzeON MzzgON MzzkOFF MzzeOFF MzzgOFF MzzkON MzaaON MzzkOFF MzaaOFF MzzkON MzzkOFF MzzkON MzzkOFF MzzkON MzzkOFF MzaaON MzaaOFF MzaaON MzzeON MzaaOFF MzzkON MzaaON MzzkOFF MzzeOFF MzaaOFF MzzeON MzzeOFF MzzeON MzaaON MzzeOFF MzaaOFF	
akxed	MzzkON MzzkOFF MzzeON MzzgON MzzgOFF MzzeOFF MzzkON MzzgON MzzeON MzzhON MzzgOFF MzzhOFF MzzhON MzzcON MzzgON MzzeOFF MzzkOFF MzzkON MzzeON MzzhOFF MzzcOFF MzzgOFF MzzkOFF MzzeOFF MzzkON MzaaON MzzkOFF MzaaOFF MzaaON MzaaOFF MzzeON MzzeOFF MzzeON MzzeON MzzeOFF MzzeON MzzgON MzzkON MzzgOFF MzzgON MzzkOFF	
akxee	MzzgOFF MzzeOFF MzaaON MzzgON MzazON MzaaOFF MzzeON MzzkON MzazOFF MzzeON MzzeOFF MzzeON MzaaON MzzkOFF MzzkON MzzgON MzaaOFF MzzeOFF MzzgOFF MzaaON MzzkOFF MzaaOFF MzzgON MzzeON MzzgOFF MzzeOFF MzzeON MzzeOFF MzazON MzazOFF MzazON MzazOFF MzazON MzzkON MzazOFF MzzkOFF MzzkON MzzeON MzzkOFF MzzeOFF MzzeON MzzeOFF MzazON MzzkON MzzeON
akxeg	MzazOFF MzzgON MzazON MzzhON MzzgOFF MzzgON MzzkON MzazOFF MzzkOFF MzziON MzzkON MzzgOFF MzzhON MzzhOFF MzzkOFF MzzgON MzaeON MzazON MzziOFF MzagON MzzgOFF MzazOFF MzzgON MzahON MzazON MzaeOFF MzahOFF MzzgON MzzgOFF MzzeOFF MzazOFF MzzeON MzagON MzaaON MzagOFF MzazON MzaeON MzzeOFF MzaaOFF MzazOFF MzahON MzaeOFF MzagOFF MzahOFF MzagON MzzgON MzagOFF MzaaON MzahON MzagON MzazON MzaeON MzaaOFF MzzgOFF MzazOFF MzzeON MzadON MzahOFF MzzeOFF MzagOFF MzadOFF MzaeOFF MzzkON MzziON MzadON MzaaON MzadOFF MzazON MzzhON MzazOFF MzaaOFF MzzkOFF MzzeON MzzgON MzaaON MzzkON MzzgOFF MzzhOFF MzzeOFF MzaeON MzagON MzaaOFF MzziOFF MzahON MzzkOFF MzaeOFF MzagOFF MzzeON MzzeOFF MzazON MzahOFF MzzeON MzahON MzazOFF MzzeOFF MzagON MzaeON MzahOFF MzagOFF MzadON MzzeON MzaeOFF MzzeOFF
akxeh	MzazON MzzeON MzazOFF MzzeOFF MzzeON MzzgON MzaeON MzzgOFF MzagON MzzeOFF MzadOFF MzaeOFF MzagOFF MzzeON MzzeOFF MzzeON MzzeOFF MzagON MzahON MzaeON MzahOFF MzahON MzaiON MzaeOFF MzzeON MzagOFF MzzeOFF MzagON MzaeON MzzeON MzzgON MzahOFF MzzkON MzziON MzzgOFF MzaiOFF MzzeOFF MzzhON MzagOFF MzzeON MzaeOFF MzzeON MzziOFF MzzhOFF MzzeOFF MzzeON MzzeOFF MzzkOFF MzzeON MzzeOFF MzzkON MzzkOFF MzaaON	
akxei	MzzeON MzaaOFF MzzkON MzazON MzzeOFF MzzkOFF MzazOFF MzzkON MzzkOFF MzazON MzazOFF MzzkON MzzkOFF MzzkON MzazON MzzkOFF MzzgON MzzkON MzzhON MzazOFF MzzkON MzazON MzzkOFF MzzkON MzzgOFF MzzhOFF MzzkOFF MzzgON MzazOFF MzazON MzazOFF MzzgOFF MzzeON MzazON MzazON MzaaON MzzeON MzzeOFF MzaaOFF MzzeON MzazOFF MzzeOFF MzazON MzzeON MzazOFF MzzeOFF
akxek	MzzeON MzzeOFF MzzkON MzazON MzzeON MzzkOFF MzzkON MzazON MzzkOFF MzzeOFF MzazOFF MzzkON MzazON MzzkOFF MzazOFF MzzkON MzzhON MzzhOFF MzazON MzzkOFF MzzkON MzazOFF MzaaON MzzeON MzaaOFF MzzkOFF MzazON MzzeOFF MzazOFF	
bzxzz	MzzeON MzzeOFF MzzkON MzzkOFF MzaaON MzaaOFF MzaaON MzaaOFF MzazON MzzeON MzzkON MzazOFF MzazON MzzkOFF MzzeOFF MzzeON MzaaON MzazOFF MzzeOFF MzaaOFF MzaaON MzaaOFF MzzkON MzzeON MzzgON MzzkOFF MzzhON MzzkON MzzhOFF MzzeOFF MzzgOFF	
bzxza	MzzgON MzzeON MzzkOFF MzzkON MzzgOFF MzzeOFF MzzeON MzzkOFF MzzeOFF MzaaON MzaaOFF MzaaON MzaaOFF MzzkON MzaaON MzazON MzzkOFF MzazOFF MzazON MzaaOFF MzazOFF MzazON MzzkON MzzkOFF MzazOFF MzaaON MzzeON MzaaOFF MzzeON MzzkON MzzeOFF MzzeON MzzkOFF MzazON MzazOFF MzzeOFF MzzeON MzazON MzzkON MzazOFF MzazON MzzkOFF MzazOFF
bzxzb	MzzeOFF MzzkON MzzkOFF MzzeON MzazON MzazOFF MzazON MzazOFF MzazON MzazOFF MzazON MzzeOFF MzazOFF MzazON MzazOFF MzaaON MzaaOFF MzaaON MzaaOFF MzaaON MzaaOFF MzzeON MzzeOFF MzzeON MzzeOFF	
bzxzc	MzzkON MzzeON MzaaON MzzeOFF MzzkOFF MzaaOFF MzaaON MzaaOFF MzzkON MzzkOFF MzazON MzaaON MzzkON MzzkOFF MzaaOFF MzazOFF MzazON MzazOFF MzzeON MzzkON MzzkOFF MzzeOFF MzzeON MzzkON MzzeOFF MzazON MzzeON MzzkOFF	
bzxzd	MzzeOFF MzzeON MzzeOFF MzzeON MzzeOFF MzazOFF MzaaON MzazON MzazOFF MzaaOFF MzzgON MzzeON MzzhON MzazON MzziON MzzgOFF MzzkON MzaeON MzzeOFF MzagON MzzhOFF MzzeON MzziOFF MzzkOFF MzzgON MzazOFF MzzeON MzzgOFF MzaeOFF MzagOFF MzzeOFF MzazON MzzeON MzazOFF MzzeOFF MzagON MzaeON MzzkON MzziON MzagOFF MzzkOFF MzzkON MzaeOFF MzzeON MzzkOFF MzzkON MzzeOFF MzzkOFF MzzkON MzzkOFF MzzkON MzzkOFF MzaeON
bzxze	MzagON MzziOFF MzahON MzaeOFF MzagOFF MzzeON MzzeOFF MzagON MzagOFF MzagON MzagOFF MzazON MzahOFF MzazOFF MzahON MzaiON MzazON MzahOFF MzazOFF MzahON MzzgON MzzeON MzzgOFF MzzeON MzzeOFF MzaiOFF MzahOFF MzzkON MzzkOFF MzzeON MzahON MzzeOFF MzahOFF MzzeON MzzkON MzzeON MzzeOFF MzzkOFF MzahON MzzhON MzzkON MzahOFF
bzxzg	MzzhOFF MzzkOFF MzzeON MzzeOFF MzahON MzahOFF MzzkON MzahON MzzkOFF MzahOFF MzzkON MzzkOFF MzzkON MzzkOFF MzzkON MzahON MzahOFF MzzkOFF MzzeON MzazON MzazOFF MzzeOFF MzzkON MzahON MzzgON MzzeON MzzhON MzzkOFF MzzhOFF MzaiON MzzeOFF MzzhON MzzhOFF MzzhON MzzgOFF MzzgON MzzhOFF MzaiOFF MzahOFF MzzgOFF MzzgON MzazON MzzgOFF MzzgON MzahON MzahOFF MzzhON
bzxzh	MzazOFF MzahON MzahOFF MzahON MzahOFF MzzhOFF MzzgOFF MzzgON MzahON MzzhON MzazON MzzhOFF MzazOFF MzzgOFF MzahOFF MzzgON MzahON MzzhON MzahOFF MzazON MzzhOFF MzzeON MzazOFF MzazON MzzgOFF MzazOFF MzzgON MzzhON MzzcON MzzbON MzzeON MzzhOFF MzzhON MzzeOFF MzzbOFF MzzbON MzzhOFF MzzhON MzzgOFF MzziON MzzkON MzzcOFF MzzgON MzzkOFF MzaeON MzzkON MzadON MzzgOFF MzagON MzadOFF MzzbOFF MzzhOFF MzziOFF MzzkOFF MzzgON MzazON MzaaON MzazOFF MzazON MzaaOFF MzziON MzzgOFF MzaaON MzzkON MzazOFF MzagON MzzhON MzaaOFF MzagOFF MzzgON MzaeOFF MzahON MzzkOFF MzaaON MzzhOFF MzaaOFF MzzeON MzziOFF MzzeOFF MzaiON MzagOFF MzazON MzahOFF MzzhON MzazOFF MzziON MzaiOFF MzziOFF MzzgOFF MzziON
bzxzi	MzziOFF MzziON MzzaON MzziOFF MzzaOFF MzziON MzzbON MzziOFF MzzbOFF MzziON MzahON MzzkON MzzkOFF MzahOFF MzzkON MzazON MzaeON MzagON MzziOFF MzzkOFF MzahON MzazOFF MzazON MzzhOFF MzagOFF MzaeOFF MzazOFF MzaiON MzazON MzzgON MzazOFF MzazON MzahOFF MzahON MzazOFF MzagON MzaeON MzaiOFF MzaiON MzzgOFF MzzgON MzahOFF MzahON MzadON MzagOFF MzziON MzzkON MzzgOFF MzadOFF MzzhON MzagON MzaiOFF MzahOFF MzzkOFF MzadON MzahON MzzkON MzzhOFF MzadOFF MzahOFF MzazON MzagOFF MzaeOFF MzzkOFF MzazOFF MzzgON MzzkON MzzkOFF MzzgOFF MzziOFF MzziON MzahON MzzkON MzziOFF MzzgON MzahOFF MzzgOFF MzzgON MzzkOFF MzziON
bzxzk	MzzgOFF MzziOFF MzziON MzzgON MzziOFF MzazON MzziON MzazOFF MzazON MzzaON MzzhON MzzgOFF MzzaOFF MzzbON MzzcON MzaaON MzahON MzazOFF MzzgON MzzeON MzzhOFF MzahOFF MzzbOFF MzaaOFF MzziOFF MzzcOFF MzzgOFF MzzeOFF MzahON MzahOFF MzahON MzahOFF MzahON MzahOFF MzzgON MzzeON MzzkON MzahON MzzgOFF MzzeOFF MzzeON MzahOFF MzzeOFF MzzkOFF MzahON MzahOFF MzahON MzahOFF MzzkON MzzkOFF MzzeON MzahON MzzeOFF MzaaON MzahOFF MzaaOFF
bzxaz	MzzkON MzzkOFF MzahON MzahON MzzeON MzahOFF MzahON MzahON MzzeON MzazON MzzeOFF MzahOFF MzzeOFF MzzgON MzazOFF MzazON MzahON MzahOFF MzazOFF MzzgOFF MzahON MzazON MzzgON MzahOFF MzazOFF MzazON MzahON MzahOFF MzazOFF MzzgOFF MzzeON MzzeOFF MzzkON MzzkOFF MzazON MzazOFF MzzeON MzahON MzazON MzzgON MzzeOFF MzahOFF MzazOFF MzazON MzazOFF MzzgOFF
bzxaa	MzzeON MzzeOFF MzzeON MzzeOFF MzahON MzahOFF MzzkON MzahON MzzkOFF MzahOFF MzahON MzahON MzahOFF MzahON MzahOFF MzzkON MzzeON MzzeOFF MzzkOFF MzahON MzahOFF MzahON MzahOFF
bzxab	MzzkON MzzkOFF MzzeON MzahON MzzeOFF MzahOFF MzzkON MzzeON MzzkOFF MzzeOFF MzzkON MzahON MzahOFF MzzeON MzzkOFF MzzeOFF
bzxac	MzahON MzahOFF MzahON MzahOFF MzzgON MzahON MzahOFF MzzgOFF MzahON MzahOFF MzzkON MzahON MzzkOFF MzzeON MzahOFF MzzeOFF MzzeON MzahON MzahOFF MzzeOFF MzahON MzzeON MzahOFF MzzeOFF MzahON MzzeON MzzgON MzaiON MzzgOFF MzahOFF MzahON
bzxad	MzahOFF MzaiOFF MzzgON MzzgOFF MzzkON MzzeOFF MzzkOFF MzzeON MzzeOFF MzzkON MzziON MzziON MzziOFF MzahON MzzkOFF MzagON MzaeON MzziON MzahOFF MzzhON MzzbON MzagOFF MzaeOFF MzzhOFF MzziOFF MzzbOFF MzzcON MzzbON MzzhON MzziON MzzkON MzzcOFF MzzhOFF MzaeON MzzbOFF MzzkOFF MzagON MzziOFF MzagOFF MzaeOFF MzzkON MzzeON	
bzxae	MzzeOFF MzzkOFF MzzeON MzzeOFF MzzeON MzaeON MzzeOFF MzzkON MzzkOFF MzzeON MzaeOFF MzzeOFF MzaeON MzagON MzzkON MzaeOFF MzzkOFF MzahON MzahOFF MzzeON MzagOFF MzzeOFF MzzeON MzzeOFF MzagON MzagOFF MzagON MzagOFF MzazON MzzeON MzazOFF MzazON MzzeOFF MzagON MzzeON MzahON MzazOFF MzagOFF MzzeOFF MzahOFF MzahON MzahOFF MzahON MzahOFF MzazON MzzgON MzzgOFF MzazOFF MzzkON MzzkOFF MzzkON	
bzxag	MzzkOFF MzaaON MzaaOFF MzzeON MzzeON MzaaON MzzeOFF MzzeON MzaaOFF MzzgON MzahON MzzgOFF MzzeOFF MzzeON MzaaON MzzgON MzaaOFF MzahOFF MzzgON MzzgOFF MzzeOFF MzzeON MzzkON MzzeON MzzeOFF MzzkOFF MzzeOFF
bzxah	MzzeON MzzgON MzzgOFF MzzeOFF MzzkON MzazON MzzkOFF MzzkON MzazOFF MzzkOFF MzzeON MzzgON MzzgOFF MzzeOFF MzzeON MzzkON MzaaON MzaaOFF MzzeOFF MzzkOFF MzzkON MzzkOFF MzzkON MzagON MzzeON MzzeOFF MzzeON MzagOFF MzzkOFF MzzeOFF MzzkON MzzkON MzzkOFF MzzeON MzzkOFF MzzeOFF MzagON MzahON
bzxai	MzagOFF MzahOFF MzagON MzagOFF MzahON MzahOFF MzzeON MzzkON MzagON MzaeON MzagOFF MzzgON MzzgOFF MzaeOFF MzaeON MzzeOFF MzzeON MzagON MzzkOFF MzzeOFF MzaeOFF MzagOFF MzzkON MzagON MzzkOFF MzzeON MzzkON MzahON MzagON MzagOFF MzzeOFF MzzkOFF MzagON MzzkON MzaeON MzahOFF MzaaON MzziON MzagOFF MzaaOFF MzaeOFF MzzkOFF MzaeON MzzkON MzagON MzahON MzzkOFF MzaeOFF MzziOFF MzzeON MzahOFF MzagOFF MzzkON MzzeOFF MzzeON MzzeOFF MzzkOFF MzagON MzaeON	
bzxak	MzagOFF MzaeOFF MzzkON MzzeON MzzeOFF MzaeON MzagON MzzkOFF MzzkON MzaeOFF MzzkOFF MzagOFF MzagON MzahON MzagOFF MzahOFF MzzkON MzzkOFF MzzgON MzazON MzazOFF MzzgON MzzgOFF MzzkON MzzgON MzazON MzzgOFF MzazOFF MzzkOFF MzzkON
bzxbz	MzazON MzzkOFF MzazOFF MzazON MzazOFF MzazON MzzkON MzazOFF MzzkOFF MzzeON MzzeOFF MzzeON MzzkON MzazON MzzeOFF MzzkOFF MzzkON MzazOFF MzzeON MzzgON MzzkOFF MzzgOFF MzzeOFF MzzgON MzazON MzazOFF MzzgOFF MzzeON MzzgON MzzgOFF MzzgON MzzkON MzzhON MzzkON MzzgOFF MzzkOFF MzziON MzzeOFF MzzeON MzzgON MzziOFF MzziON MzzkON MzzgOFF MzzeON MzzgON MzazON MzadON MzzgOFF MzzgON MzaeON MzzeOFF MzzkOFF MzziOFF MzzgOFF MzzhOFF MzaeOFF MzaeON MzazOFF MzaeOFF	
bzxba	MzziON MzzkON MzzaON MzzhON MzbcON MzzkOFF MzzhOFF MzzeON MzadOFF MzbbON MzzeOFF MzziOFF MzbaON MzzeON MzzgON MzaaON MzzaOFF MzbcOFF MzzgOFF MzzgON MzaaOFF MzbdON MzzeOFF MzzeON MzbbOFF MzzhON MzziON MzzkON MzzkOFF MzzeOFF MzzgOFF MzbaOFF MzziOFF MzaaON MzaaOFF MzzhOFF MzzhON MzaaON MzaaOFF MzzhOFF MzzhON MzbaON MzziON MzakON MzzaON MzbcON MzbbON MzaiON MzziOFF MzzaOFF MzbdOFF MzzhOFF MzbcOFF MzakOFF MzbdON MzbbOFF MzakON MzbdOFF MzahON MzbaOFF MzakOFF MzagON MzaeON MzziON MzaiOFF MzzkON MzahOFF MzaeOFF MzagOFF MzzhON MzzkOFF MzahON MzziOFF MzahON MzagON MzziON MzaeON MzahOFF MzzkON MzzhOFF MzzkOFF MzziOFF MzahON MzaeOFF
bzxbb	MzagOFF MzahOFF MzahON MzahOFF MzahON MzahOFF MzaeON MzagON MzahON MzaeOFF MzahOFF MzahON MzagOFF MzahOFF MzagON MzaeON MzziON MzzkON MzzaON MzzhON MzagOFF MzbcON MzbbON MzaeON MzbaON MzaeOFF MzzkOFF MzbdON MzbcOFF MzbeON MzziOFF MzzaOFF MzzhOFF MzbaOFF MzbgON MzbbOFF MzbdOFF MzbeOFF MzahON MzbhON MzbgOFF MzahOFF MzaaON MzzhON MzzaON MzbcON MzaaOFF MzzhOFF MzbbON MzzhON MzbaON MzbhOFF MzbhON MzzaOFF MzbdON MzzhOFF MzbiON MzbcOFF MzbeON MzahON MzbbOFF MzaaON MzbkON MzchON MzbbON MzaaOFF MzbeOFF MzbiOFF MzahOFF MzbhOFF MzbcON MzzaON MzbdOFF MzbaOFF MzbkOFF MzbbOFF MzzhON MzchOFF MzbcOFF MzzaOFF
bzxbc	MzahON MzaaON MzaaOFF MzzhOFF MzagON MzzhON MzziON MzahOFF MzagOFF MzagON MzzkON MzzgON MzadON MzziOFF MzzgOFF MzzgON MzzkOFF MzadOFF MzzhOFF MzazON MzzgOFF MzagOFF MzazOFF MzazON MzazOFF MzagON MzagOFF MzadON MzziON MzzkON MzadOFF MzzkOFF MzzhON MzzkON MzagON MzzkOFF MzzhOFF MzziOFF MzahON MzagOFF MzahOFF MzahON MzziON MzagON MzzkON MzahOFF MzziOFF MzzkOFF MzagOFF MzchON MzagON MzagOFF MzchOFF MzagON
bzxbd	MzagOFF MzchON MzbkON MzbiON MzbhON MzagON MzchOFF MzbkOFF MzbgON MzbhOFF MzbiOFF MzagOFF MzbeON MzbdON MzbaON MzbgOFF MzbbON MzbeOFF MzzkON MzbcON MzbdOFF MzagON MzzaON MzbaOFF MzziON MzahON MzzkOFF MzbbOFF MzzhON MzagOFF MzzkON MzbcOFF MzzaOFF MzahOFF MzzhOFF MzzkOFF MzagON MzzhON MzzkON MzaeON MzazON MzzhOFF MzazOFF MzzkOFF MzzkON MzahON MzahOFF MzadON MzagOFF MzahON MzaeOFF MzagON MzzkOFF MzahOFF MzziOFF MzzkON MzagOFF MzzkOFF MzagON MzziON MzagOFF MzzkON MzadOFF MzziON MzagON MzziOFF MzziON MzziOFF MzazON MzagOFF MzagON MzazOFF MzzgON MzzkOFF MzazON MzagOFF MzagON MzzgOFF MzaeON MzazOFF MzagON MzagOFF MzzkON MzaeOFF MzaeON MzzkOFF MzagOFF
bzxbe	MzaeOFF MzaeON MzagON MzahON MzzkON MzagOFF MzaeOFF MzahOFF MzahON MzziON MzahOFF MzzhON MzzgON MzzkOFF MzaaON MzzhOFF MzaaOFF MzziOFF MzahON MzzgOFF MzzkON MzzgON MzzkOFF MzzkON MzahOFF MzahON MzzkOFF MzahOFF MzzhON MzziON MzzkON MzzgOFF MzzkOFF MzzaON MzahON MzziOFF MzzhOFF MzahOFF MzziON MzzhON MzzaOFF MzahON MzziOFF MzzhOFF MzaaON MzziON MzaaOFF MzziOFF MzahOFF MzziON MzziOFF MzahON
bzxbg	MzziON MzaaON MzagON MzziOFF MzaaON MzahOFF MzaaOFF MzagOFF MzziON MzzhON MzzkON MzaaON MzzkOFF MzaaOFF MzadON MzaeON MzziOFF MzaaON MzzhOFF MzadON MzzkON MzziON MzagON MzaaOFF MzadOFF MzzkON MzaeOFF MzzaON MzzhON MzzkOFF MzagOFF MzzaOFF MzagON MzziOFF MzzhOFF MzagOFF MzagON MzagOFF MzzkON MzzkOFF MzzkON MzagON MzagOFF MzzkOFF MzagON MzaeON MzzkON MzzaON MzzkOFF MzagOFF MzagON MzahON MzagOFF MzahOFF MzagON MzaeOFF MzzhON MzziON MzaeON MzadON MzzhOFF MzaeOFF MzaaON MzagOFF MzziOFF MzadOFF MzzkON MzadON MzzaOFF MzaaOFF MzadOFF MzzkOFF MzadON MzziON MzzkON MzzhON MzzkOFF MzzbON MzzcON
bzxbh	MzziOFF MzzhOFF MzzbOFF MzzdON MzzcOFF MzzdON MzadOFF MzzdOFF MzadON MzaeON MzagON MzadOFF MzaeOFF MzagOFF MzagON MzagOFF MzagON MzagOFF MzahON MzaiON MzaiOFF MzahOFF MzahON MzaaON MzahOFF MzaaOFF MzaaON MzzdON MzzdOFF MzaaOFF MzzcON MzzbON MzzhON MzzaON MzziON MzzcOFF MzzkON MzzbOFF MzzaOFF MzzhOFF MzaeON MzagON MzziOFF MzzkOFF
bzxbi	MzaeOFF MzahON MzaaON MzagOFF MzaaON MzaaOFF MzagON MzaeON MzagOFF MzziON MzahOFF MzzkON MzaeOFF MzzkOFF MzziOFF MzziON MzaaON MzaaOFF MzzhON MzaaON MzzbON MzzcON MzahON MzaaOFF MzziOFF MzzhOFF MzzbOFF MzzbON MzzhON MzagON MzzbOFF MzaaON MzagOFF MzzhOFF MzzbON MzahOFF MzaaOFF MzzcOFF MzzhON MzahON MzziON MzaaON MzahOFF MzzkON MzaaOFF MzaeON MzagON MzzbOFF MzzhOFF MzzkOFF MzaaON MzziOFF MzagOFF MzaeOFF MzahON MzaaOFF MzahOFF MzahON MzzkON
bzxbk	MzzhON MzziON MzahOFF MzzhOFF MzziOFF MzzkOFF MzaeON MzagON MzahON MzaeON MzaeOFF MzagOFF MzaaON MzaeON MzagON MzahOFF MzaeOFF MzaaOFF MzaeON MzahON MzaiON MzaeOFF MzaaON MzaeON MzaiOFF MzaeOFF MzagOFF MzaaOFF MzaaON MzagON MzaeON MzaaOFF MzagOFF MzagON MzagON MzaeOFF MzaeON MzaeOFF MzaeON MzaiON MzaeOFF MzaiOFF MzagOFF MzagON MzagOFF MzahOFF
bzxcz	MzahON MzaeON MzagON MzahOFF MzzkON MzziON MzaeOFF MzzhON MzzkOFF MzzgON MzaeON MzaaON MzziOFF MzzhOFF MzziON MzzgOFF MzaaOFF MzzkON MzzhON MzaeOFF MzagOFF MzzbON MzzkOFF MzzgON MzzcON MzzhON MzziOFF MzzgON MzzeON MzzgOFF MzzbOFF MzziON MzzkON MzahON MzadON MzzcOFF MzzhOFF MzahOFF MzziOFF MzaeON MzzgOFF MzzkOFF MzagON MzadOFF MzzeOFF MzzeON MzaeOFF MzzgON MzagOFF MzagON MzahON MzzgOFF MzagOFF MzagON MzzgON MzahOFF MzaeON MzadON MzzgOFF MzahON MzzeON MzaeOFF MzagOFF MzzeOFF MzadOFF MzahOFF MzahON MzadON MzziON MzzkON MzahOFF MzadOFF MzzhON MzzkOFF MzzhOFF MzazON MzziOFF MzzgON MzzkON MzzeON MzzgOFF MzahON MzzeOFF MzzkOFF MzazOFF MzazON MzahOFF MzazOFF MzzeON MzaaON MzazON MzzeOFF MzaaOFF MzzeON MzzeOFF MzazOFF
bzxca	MzzeON MzzeOFF MzzkON MzzkOFF MzzkON MzzkOFF MzzkON MzzkOFF MzzkON MzzeON MzzkOFF MzahON MzzeOFF MzzeON MzahOFF MzaaON MzzgON MzzgOFF MzzkON MzaaOFF MzzeOFF MzzgON MzzeON MzahON MzzkOFF MzzcON MzzbON MzzkON MzzeOFF MzzgOFF MzzgON MzzgOFF MzahOFF MzahON MzzkOFF MzahOFF MzzbOFF MzzbON MzzbOFF MzzbON MzzbOFF MzzgON MzzgOFF MzazON MzazOFF MzzbON MzzbOFF MzzgON MzzeON MzahON MzzcON MzzcOFF MzzgON MzahOFF MzzgOFF
bzxcb	MzahON MzzeOFF MzzgON MzzeON MzzkON MzzcON MzzbON MzzkOFF MzahOFF MzzgON MzzaON MzzcOFF MzzeOFF MzzgOFF MzbcON MzzbOFF MzbbON MzzaOFF MzzhON MzbaON MzagON MzbcOFF MzzhOFF MzbdON MzbeON MzbbOFF MzbaOFF MzbdOFF MzbgON MzbeOFF MzagOFF MzzkON MzahON MzazON MzagON MzaeON MzahOFF MzbgOFF MzbhON MzazOFF MzagOFF MzaeOFF MzbiON MzadON MzzkOFF MzaeON MzbkON MzagON MzbhOFF MzadOFF MzczON MzbiOFF MzcgON MzaeOFF MzzhON MzzhOFF MzagOFF MzbkOFF MzbkON MzcgOFF MzagON MzazON MzzgON MzczOFF MzazOFF MzagON MzzkON MzbkOFF MzazON MzagOFF MzziON MzzgOFF MzazOFF MzziOFF MzazON MzagON MzazOFF MzahON MzzkOFF MzzkON MzzkOFF MzagON MzahOFF MzahON MzagOFF MzahOFF MzahON MzbkON MzchON MzagON MzahOFF MzzkON MzbiON MzagOFF
bzxcc	MzchOFF MzagON MzbiOFF MzagON MzzkOFF MzbkOFF MzagOFF MzagOFF MzagON MzahON MzagON MzahOFF MzagOFF MzagON MzahON MzagOFF MzahOFF MzahON MzahOFF MzahON MzahOFF MzzkON MzzkOFF MzahON MzahOFF MzzgON MzzgON MzzgOFF MzzgOFF MzbiON MzbkON MzchON MzbiOFF MzahON MzchOFF MzbiON	
bzxcd	MzbiON MzzkON MzbiOFF MzahOFF MzbkOFF MzazON MzazOFF MzazON MzzgON MzzkOFF MzazOFF MzzgOFF MzbiON MzbkON MzczON MzagON MzcgON MzbiOFF MzbkOFF MzagOFF MzagON MzcgOFF MzcgON MzagOFF MzcaON MzcbON MzccON MzagON MzcaOFF MzcgOFF MzczOFF MzcbOFF MzagOFF MzcbON MzagON MzcgON MzcaON MzceON MzagOFF MzccOFF MzczON MzcbOFF MzcaOFF MzbkON MzceOFF MzchON MzczOFF MzcgOFF MzczON MzaaON MzchOFF MzcgON MzahON MzaaOFF MzcaON MzcbON MzahOFF MzbkOFF MzahON MzccON MzczOFF MzcaOFF MzcgOFF MzaaON MzcbOFF
bzxce	MzahOFF MzcbON MzaaOFF MzccOFF MzahON MzcaON MzaiON MzcaOFF MzceON MzccON MzahOFF MzceOFF MzzkON MzaiOFF MzzkOFF MzahON MzaaON MzceON MzccOFF MzcaON MzcgON MzceOFF MzagON MzahOFF MzczON MzaaOFF MzbkON MzcaOFF MzcbOFF MzagOFF MzcgOFF MzczOFF MzbkOFF MzagON MzbkON MzczON MzcgON MzbkOFF MzcaON MzagOFF MzagON MzagON MzcaOFF MzbkON MzcgON MzagOFF MzagON MzcgOFF MzagOFF MzagON MzczOFF MzaeON MzadON MzagOFF MzbkOFF MzbkON MzaeOFF MzczON MzadOFF MzczOFF MzaaON MzbkOFF MzaaOFF MzadON MzbkON MzchON
bzxcg	MzbiON MzzkON MzchOFF MzzkOFF MzbkOFF MzaeON MzagON MzbiOFF MzaeOFF MzadOFF MzahON MzbiON MzbkON MzagOFF MzbiOFF MzczON MzagON MzahON MzcgON MzahOFF MzbkOFF MzcgON MzagON MzcgOFF MzzkON MzcgON MzagOFF MzzgON MzbkON MzagON MzzhON MzzkOFF MzcgON MzzhOFF MzzkON MzbiON MzzgOFF MzcgOFF MzzgON MzzkOFF MzbhON MzzgOFF MzczOFF MzbkON MzzhON MzzgON MzbkOFF MzzhOFF MzbiOFF MzbgON MzagOFF MzbhOFF MzaaON MzzgOFF MzagON MzaaOFF MzbeON MzagOFF MzbdON MzaaON MzbgOFF MzagON MzbaON MzbeOFF MzakON MzaaOFF MzaeON MzaaON MzagOFF MzaiON MzbdOFF MzbaOFF MzahON MzaaOFF MzaeON MzakOFF MzagON MzaeOFF MzadON MzaiOFF MzahOFF MzagOFF MzziON MzaeOFF MzziOFF MzaaON MzadOFF MzadON MzaaOFF MzzgON MzzgOFF MzaaON MzzgON MzzkON MzazON MzaaOFF MzzkOFF MzzkON MzaaON MzzgOFF
bzxch	MzacON MzziON MzaaOFF MzzkON MzazOFF MzzkOFF MzadOFF MzzkON MzaaON MzzkOFF MzaaOFF MzaaON MzaaOFF MzzhON MzzhOFF MzacOFF MzacON MzaeON MzagON MzahON MzagOFF MzaiON MzaaON MzaeOFF MzziOFF MzzkON MzaaOFF MzahOFF MzzkOFF MzaiOFF MzacOFF MzacON MzabON MzaaON MzaiON MzahON MzabOFF MzaaOFF MzaiOFF MzacOFF MzahOFF MzazON MzzkON MzagON MzazOFF MzzkOFF MzaaON MzaeON MzzgON MzaaOFF MzziON MzaaON MzzhON MzzgOFF MzzcON MzzgON MzaeOFF MzagOFF MzzhOFF MzzeON MzziOFF MzzcOFF MzzeOFF MzzgOFF MzzeON MzzeOFF MzazON MzzgON MzazOFF MzazON MzzeON MzzgOFF MzzeOFF MzzeON MzazOFF MzazON MzazOFF MzaaON MzazON MzzeOFF MzaaOFF MzaaON MzzeON MzazOFF MzzeOFF MzaaOFF
bzxci	MzazON MzaaON MzzgON MzzeON MzzgOFF MzaaOFF MzzeOFF MzazOFF MzzeON MzzeOFF MzazON MzzeON MzazOFF MzazON MzzgON MzazOFF MzazON MzzcON MzazOFF MzzbON MzzeOFF MzzhON MzziON MzzgOFF MzzgON MzzcOFF MzzeON MzzkON MzazON MzzbOFF MzzeOFF MzzgOFF MzaeON MzagON MzzkOFF MzziOFF MzzhOFF MzazOFF MzaeOFF MzagOFF MzagON MzazON MzzgON MzazON MzzgOFF MzzgON MzzkON
bzxck	MzzgOFF MzzkOFF MzazOFF MzazON MzazOFF MzazON MzagOFF MzazOFF MzagON MzagOFF MzagON MzagOFF MzagON MzagOFF MzazON MzazOFF MzagON MzagOFF MzagON MzazON MzzgON MzazOFF MzazON MzzkON MzagOFF MzagON MzzgOFF MzazOFF MzzkOFF MzazON MzahON MzaaON MzazOFF MzazON MzaaOFF MzagOFF MzazOFF MzazON MzazOFF MzazON MzagON MzazOFF MzagOFF MzahOFF MzagON
bzxdz	MzagOFF MzagON MzaaON MzaaOFF MzagOFF MzagON MzagOFF MzazON MzagON MzazOFF MzazON MzazOFF MzagOFF MzagON MzagOFF MzazON MzazOFF MzagON MzaaON MzagOFF MzagON MzazON MzaaOFF MzagOFF MzazOFF MzazON MzaaON MzazOFF MzagON MzaaOFF MzagOFF MzzkON MzzkOFF MzazON MzzkON MzaaON MzazOFF MzagON MzaaOFF MzagOFF MzagON MzzkOFF	
bzxda	MzagON MzagOFF MzagOFF MzzkON MzagON MzacON MzacOFF MzagOFF MzacON MzagON MzazON MzacOFF MzagON MzazOFF MzzgON MzagOFF MzzgOFF MzzkOFF MzzkON MzzkOFF MzacON MzacOFF MzzkON MzacON MzacOFF MzzkOFF MzzkON MzaaON MzzkOFF MzaaOFF MzagON MzagOFF MzagON MzzkON MzazON MzzkOFF MzzkON MzagOFF MzazOFF MzzkOFF MzzkON MzzkOFF MzzgON MzzkON MzzgOFF MzzkOFF MzzkON MzzkOFF
bzxdb	MzzgON MzzgOFF MzacON MzacOFF MzzgON MzaaON MzzgOFF MzaaOFF MzzkON MzzkOFF MzzkON MzagON MzacON MzacOFF MzacON MzagOFF MzacOFF MzzgON MzzgOFF MzaaON MzzkOFF MzaaOFF MzaaON MzzkON MzaaOFF MzazON MzzkOFF MzzkON MzazOFF MzazON MzzgON MzzgOFF MzzkOFF MzzgON MzzhON MzazOFF MzahON MzzhOFF MzzhON MzzhOFF
bzxdc	MzzhON MzahOFF MzagON MzzgOFF MzziON MzagOFF MzzkON MzaeON MzadON MzzkOFF MzziOFF MzzhOFF MzzkON MzaeOFF MzziON MzzhON MzzkOFF MzzaON MzadOFF MzzhOFF MzbcON MzziOFF MzzhON MzagON MzziON MzbcOFF MzzkON MzagOFF MzzaOFF MzzhOFF MzzhON MzzgON MzagON MzziOFF MzzkOFF MzzhOFF MzzhON MzagOFF MzzgOFF MzagON MzahON MzziON MzagOFF MzzgON MzziOFF MzzgOFF MzzhOFF MzzhON MzziON MzahOFF MzziOFF MzziON MzzgON MzziOFF MzziON MzzgOFF MzzkON MzaeON
bzxdd	MzagON MzzhOFF MzziOFF MzzkOFF MzahON MzadON MzzkON MzziON MzadOFF MzagOFF MzaeOFF MzzhON MzzkOFF MzziON MzahOFF MzzkON MzahON MzzhOFF MzahOFF MzaeON MzziOFF MzzkON MzzkOFF MzziON MzahON MzaeOFF MzzhON MzzkOFF MzaaON MzaaOFF MzzkON MzzhOFF MzaeON MzahOFF MzziOFF MzzkOFF MzaaON MzahON MzziON MzzkON MzaaOFF MzaeOFF MzahOFF MzahON MzziOFF MzahOFF MzzhON MzziON MzagON MzaeON MzzkOFF MzziOFF MzziON MzaaON MzacON MzzkON MzzhOFF MzzhON MzzgON MzzeON MzacON MzagOFF MzaaOFF MzzkOFF MzzbON MzaeOFF MzzcON MzzeOFF MzzbOFF MzzcOFF MzzhOFF MzadON MzzhON MzziOFF MzaeON MzzkON MzzcON MzzhOFF MzacOFF MzziON MzzhON MzazON MzadOFF MzaeOFF MzzbON MzzkOFF MzazOFF MzzhOFF MzziOFF MzzbOFF MzzhON
bzxde	MzzhOFF MzzhON MzzhOFF MzzhON MzzcOFF MzzcON MzzhOFF MzzhON MzzbON MzzcOFF MzzhOFF MzzgON MzzbOFF MzzcON MzzbON MzzgOFF MzzbOFF MzzgON MzzcOFF MzzgOFF MzzgON MzzcON MzzcOFF MzzgOFF MzzgON MzzcON MzzcOFF MzzcON MzzcOFF MzzcON MzzcOFF MzzcON MzzgOFF MzzgON MzzcOFF MzzhON MzzhOFF MzzgOFF MzzcON MzzhON MzzkON MzziON MzzcOFF MzzcON MzzhOFF MzaeON MzzkOFF MzagON MzzcOFF MzzcON MzziOFF MzziON MzagOFF MzzcON MzzhON MzzhOFF MzziOFF MzzkOFF MzaeOFF MzzhON MzzgON MzzgOFF MzzcOFF MzzhOFF MzzgON
bzxdg	MzzcON MzzcOFF MzzgOFF MzzcON MzzcOFF MzzgON MzzgON MzzcON MzzcOFF MzzgOFF MzzgON MzzbON MzzcON MzzbOFF MzzhON MzzcOFF MzzhOFF MzzcON MzzgOFF MzzgON MzzcOFF MzzbON MzzcON MzzgOFF MzzgON MzzbOFF MzzgOFF MzzgON MzzcOFF MzzcON MzzbON MzzgOFF MzzgON MzzcOFF MzzhON MzzbOFF MzzhOFF MzzcON MzzcON MzzgOFF MzzgON MzzcOFF
bzxdh	MzzgOFF MzzgON MzzhON MzzhOFF MzzgOFF MzzgON MzzhON MzzhOFF MzzcON MzzgOFF MzzcOFF MzzhON MzzcON MzzgON MzzhOFF MzzcOFF MzzhON MzzgOFF MzzgON MzzgOFF MzzhON MzzhOFF MzzgON MzzhON MzzhOFF MzzcON MzzgOFF MzzgON MzzcOFF MzzhON MzzgOFF MzzhOFF MzzgON MzzhON MzzgON MzzhOFF MzzhON MzzhOFF MzzgOFF MzzgON MzzgOFF MzzgON
bzxdi	MzzgOFF MzzgON MzzcON MzzgOFF MzzgON MzzhON MzzcOFF MzzgOFF MzzgON MzzhOFF MzzcON MzzgOFF MzzgON MzzcOFF MzzgOFF MzzcON MzzgON MzzcOFF MzzgOFF MzzgON MzzcON MzzcOFF MzzgOFF MzzgON MzzcON MzzgOFF MzzbON MzzgON MzzbOFF MzzcOFF MzzcON MzzcOFF MzzcON	
bzxdk	MzzcOFF MzzhON MzzhOFF MzzhON MzzhOFF MzzcON MzzcOFF MzzhON MzzcON MzzkON MzzhOFF MzzgOFF MzzgON MzzcOFF MzzkOFF MzzgOFF MzazON MzzcON MzzgON MzazOFF MzzcOFF MzzcON MzzbON MzzkON MzzbOFF MzzgON MzzcOFF MzzkOFF MzzgON MzzgOFF MzzcON MzzgON MzzgOFF MzzcON MzzcOFF MzzgOFF MzzcOFF MzzcON MzzgON MzzgOFF MzzcOFF MzzgON MzzgOFF MzzcON
bzxez	MzzgON MzzgOFF MzzcOFF MzzkON MzzkOFF MzzgON MzzgOFF MzzgON MzzgOFF MzzgON MzzgOFF MzzcON MzzcOFF MzzgON MzzgOFF MzzgON MzzgOFF MzzgON MzzcON MzzkON MzzgOFF MzzgON MzzcOFF MzzgOFF MzzbON MzzkOFF MzzkON MzzbOFF MzzgON MzzcON MzzkOFF MzzbON MzzgOFF MzzcOFF MzzcON
bzxea	MzzdON MzzgON MzzeON MzzbOFF MzzcOFF MzzdOFF MzzcON MzzgOFF MzzeOFF MzzkON MzzeON MzzcOFF MzzcON MzzgON MzzcOFF MzzeOFF MzzcON MzzeON MzzkOFF MzzgOFF MzzcOFF MzazON MzzkON MzzeON MzzeOFF MzzgON MzzkOFF MzazOFF MzzcON MzzcOFF MzzkON MzzgOFF MzzeOFF MzzkOFF MzzkON MzzkOFF MzzkON MzzkOFF MzzgON MzzeON MzzgOFF MzzgON MzzgOFF MzzeOFF MzzgON MzzcON MzzeON MzzcOFF MzzgOFF MzzeOFF MzzgON MzzeON MzzgOFF MzzeOFF MzzeON MzzgON MzzkON MzzeOFF MzzkOFF MzzgOFF MzzkON MzzeON
bzxeb	MzzgON MzzkOFF MzzkON MzzdON MzzcON MzzkOFF MzzgOFF MzzbON MzzeOFF MzzhON MzzdOFF MzziON MzzcOFF MzzbOFF MzadON MzzhOFF MzziOFF MzadOFF MzzkON MzaeON MzzkOFF MzagON MzahON MzaeOFF MzzkON MzahON MzagOFF MzzhON MzahOFF MzahON MzzhOFF MzzkOFF MzahOFF MzzcON MzaeON MzagON MzadON MzzkON MzzhON MzagOFF MzadOFF MzzkOFF MzadON MzzkON MzaeON MzzhOFF MzzcOFF MzagON MzzcON MzzkOFF MzadOFF MzaeOFF MzzgON MzzkON MzagOFF MzzgOFF MzzcOFF MzzcON MzzcOFF MzzkOFF MzzgON MzzgOFF
bzxec	MzagON MzaeON MzadON MzzgON MzadOFF MzzgOFF MzagOFF MzzgON MzzkON MzzhON MzziON MzzkON MzzgON MzzgOFF MzaeOFF MzzgOFF MzzkOFF MzzgON MzzbON MzzcON MzzkON MzziOFF MzzbOFF MzzdON MzzeON MzzkOFF MzzdOFF MzzcOFF MzzeOFF MzzhOFF MzzkON MzzeON MzzgOFF MzzgON MzzkOFF MzzeON MzzeOFF MzzcON MzzgOFF MzzcOFF MzzeOFF MzzeON MzzkON MzzeOFF MzzeON MzzgON MzzeON MzzkOFF MzzeOFF MzzgOFF MzzgON MzazON MzzgOFF MzzeON MzazOFF MzzeOFF MzazON
bzxed	MzzgON MzzeON MzazOFF MzzgOFF MzzeOFF MzazON MzazOFF MzzgON MzazON MzzgOFF MzazOFF MzzeON MzzeOFF MzazON MzaaON MzaaOFF	MzzcON MzazOFF MzzkON MzzeON MzzkOFF MzzkON MzzeOFF MzzeON MzzcOFF MzzgON MzzeOFF MzzkOFF MzzgOFF MzzkON MzzkOFF MzzkON MzzkOFF MzzcON MzzcOFF MzzeON MzzeOFF MzzeON
bzxee	MzzeOFF MzzcON MzzkON MzzeON MzazON MzaaON MzzbON MzzhON MzzgON MzziON MzaaOFF MzzkOFF MzzgOFF MzzgON MzziOFF MzziON MzzgOFF MzzcON MzzeOFF MzzcOFF MzzeON MzzhON MzzcON MzazOFF MzzbOFF MzzeOFF MzzbON MzzcOFF MzzcON MzziOFF MzzcOFF MzzcON MzzbOFF MzziON MzzeON MzzeOFF MzzhOFF MzzbON MzzhON MzzbOFF MzzcOFF MzzeON MzzeOFF MzzbON MzziOFF MzzhOFF MzzhON MzzcON MzzeON MzziON MzazON MzzgON MzzcOFF MzzcON MzazOFF MzzgOFF MzzkON MzzgON MzzgOFF MzziOFF MzzeOFF MzzhOFF MzzbOFF MzzbON MzzbOFF MzzeON MzzkOFF MzzkON MzzeOFF MzzkOFF MzzeON MzzcOFF MzzeOFF MzzeON MzzcON MzzcOFF MzzeOFF
bzxeg	MzzkON MzzcON MzzgON MzzcOFF MzzkOFF MzzcON MzzgOFF MzazON MzzcOFF MzzeON MzzeOFF MzzeON MzazOFF MzzeOFF MzzcON MzzcOFF MzzcON MzzcOFF MzzkON MzzgON MzzgOFF MzzkOFF MzzeON MzzhON MzzkON MzzcON MzzhOFF MzzeOFF MzzeON MzzcOFF MzzkOFF MzzgON MzzgOFF MzzeOFF MzzkON MzzkOFF MzzeON MzzcON MzzkON MzzeOFF MzzcOFF MzzgON MzzhON MzzcON MzzgOFF MzzhOFF MzzkOFF MzzcOFF MzzcON
bzxeh	MzzcOFF MzzcON MzzcOFF MzzgON MzzhON MzzhOFF MzzgOFF MzzcON MzzcOFF MzzhON MzzgON MzzgOFF MzzkON MzzeON MzzhOFF MzzhON MzzkOFF MzzhOFF MzzeON MzzgON MzzkON MzzeOFF MzzgOFF MzzkOFF MzzcON MzzkON MzzeON MzzkOFF MzzgON MzzkON MzzhON MzzcOFF MzzkOFF MzzgOFF MzzeOFF MzzhOFF MzzeON MzzeOFF MzzhON MzazON MzzhOFF MzzgON MzazOFF MzzgOFF MzzgON MzzkON MzzgOFF MzazON MzzkOFF MzazOFF
bzxei	MzzkON MzzcON MzzkOFF MzzcOFF MzzkON MzzcON MzzkOFF MzzcOFF MzzkON MzzcON MzzkOFF MzzgON MzzkON MzzcOFF MzzcON MzzkOFF MzzgOFF MzzcOFF MzzcON MzzeON MzzhON MzazON MzzcOFF MzazOFF MzzeOFF MzzhOFF MzzeON MzzeOFF MzzeON MzzeOFF MzazON MzazOFF MzazON MzazON MzazOFF MzazON MzazON MzazOFF MzazOFF MzzeON MzzcON MzzgON MzzkON
bzxek	MzzgOFF MzzgON MzzkOFF MzzeOFF MzzeON MzzcOFF MzzeOFF MzzeON MzzgOFF MzzgON MzzgOFF MzzbON MzzgON MzzeOFF MzzhON MzzcON MzzgOFF MzzeON MzzhOFF MzzgON MzzbOFF MzzhON MzzcOFF MzzcON MzzhOFF MzzgOFF MzzeOFF MzzkON MzzcOFF MzzcON MzzkOFF MzzcOFF MzzeON MzzeOFF MzzcON MzzkON MzazON MzzcOFF MzzkOFF MzazOFF MzzkON MzzgON MzazON MzziON MzzhON MzzcON MzazOFF MzziOFF MzzkOFF MzzhOFF MzzeON MzzeOFF MzazON MzzgOFF MzzgON MzazON MzazOFF MzzeON MzazON MzzhON MzziON MzazOFF MzzeOFF MzzaON MzzgOFF MzziOFF MzziON MzzeON MzzgON
baxzz	MzzkON MzaeON MzzaOFF MzagON MzzgOFF MzzcON MzzkOFF MzziOFF MzzcOFF MzadON MzzhOFF MzziON MzzkON MzzcON MzagOFF MzzcOFF MzadOFF MzzaON MzzhON MzaeOFF MzzkOFF MzzaOFF MzzeOFF MzziOFF MzziON MzzhOFF MzziOFF MzziON MzzhON MzzcON MzzbON MzzaON MzbcON MzziOFF MzbbON MzzaOFF MzbaON MzzeON MzbcOFF MzzhOFF MzzhON MzziON MzzeOFF MzzeON MzzkON MzbcON MzzeOFF MzaeON MzagON MzzaON MzzkOFF MzzcOFF MzbbOFF MzzbOFF MzahON MzbaOFF MzzkON MzzhOFF MzbcOFF MzzaOFF MzagOFF MzzkOFF MzziOFF MzagON MzahOFF MzahON MzaeOFF MzagOFF MzzeON MzagON MzzgON MzahOFF MzahON MzzhON MzziON MzzkON MzagOFF MzzeOFF MzzgOFF MzziOFF MzzkOFF MzzhOFF MzaeON MzagON MzahOFF MzahON MzziON MzzkON MzzhON MzzgON MzzhOFF MzzkOFF MzzgOFF MzaeOFF
baxza	MzziOFF MzagOFF MzahON MzzgON MzahOFF MzahON MzaaON MzaaOFF MzaiON MzzgOFF MzaiOFF MzazON MzaiON MzazOFF MzaiOFF MzazON MzazOFF MzahOFF MzzgON MzaaON MzazON MzahON MzazOFF MzaaOFF MzzhON MzazON MzzhOFF MzzgOFF MzazOFF MzzgON MzzgOFF MzzgON MzazON MzazOFF MzzgON MzzgOFF MzagON MzaeON MzagOFF MzadON MzzkON MzahOFF MzziON MzadOFF MzzhON MzagON MzzkOFF MzaeOFF MzahON MzagOFF MzzbON MzzcON MzziON MzzhOFF MzziOFF MzzbOFF MzzbON MzzgON MzahOFF MzaiON MzahON MzzbOFF MzzbON MzahOFF MzzbOFF MzzgOFF MzahON MzzcOFF MzzkON MzzcON
baxzb	MzaeON MzzcOFF MzagON MzahOFF MzziON MzzhON MzagOFF MzzgON MzaiOFF MzzhOFF MzaeOFF MzzeON MzzkOFF MzziOFF MzzgOFF MzzgON MzzeOFF MzzgOFF MzzcON MzzeON MzzcOFF MzzkON MzzeOFF MzzgON MzzeON MzzgON MzzeOFF MzzgOFF MzzkOFF MzzkON MzzcON MzzcOFF MzzkOFF MzzcON MzzcOFF MzzcON MzzcOFF
baxzc	MzzkON MzzkOFF MzzbON MzzbOFF MzzcON MzzcOFF MzazON MzazOFF MzazON MzazOFF MzzeON MzzeOFF MzzkON MzzkOFF MzzgON MzzeON MzzgOFF MzzgON MzzcON MzzgOFF MzzcOFF MzzeOFF	
baxzd	MzzeON MzzcON MzzcOFF MzzeOFF MzzeON MzzkON MzazON MzazOFF MzzkOFF MzzgON MzzeON MzzgOFF MzzkON MzzeOFF MzzeON MzzcON MzzeOFF MzzkOFF MzzcOFF MzzeON MzzgON MzzcON MzzgOFF MzzcOFF MzzgON MzzgOFF MzzeOFF MzzcON MzzcOFF MzzcON MzzcOFF MzzcON MzzcOFF MzzgON MzzgOFF MzzeON
baxze	MzzeOFF MzzkON MzzkOFF MzzgON MzzkON MzzkOFF MzzgOFF MzzgON MzzcON MzzgOFF MzzcOFF MzzcON MzzcOFF MzzcON MzzcOFF MzzcON MzzkON MzzcOFF MzzkOFF MzzkON MzzkOFF MzzcON MzzgON MzzcOFF MzzgOFF MzzgON
baxzg	MzzgOFF MzzcON MzzcOFF MzzgON MzaaON MzaaOFF MzzgOFF MzzgON MzzeON MzzgOFF MzzgON MzzkON MzzeON MzzkON MzzeOFF MzzkOFF MzzeOFF MzzeON MzzeOFF MzzeON MzzhON MzzkON MzzcON MzzhOFF MzzkOFF MzzgOFF MzzgON MzzgOFF MzzgON MzzcOFF MzzkON MzzcON MzzgOFF MzzeOFF MzazON
baxzh	MzzeON MzzkOFF MzazOFF MzzcOFF MzzeOFF MzzeON MzazON MzazOFF MzzgON MzzcON MzzeOFF MzzbON MzzgOFF MzzbOFF MzzhON MzzkON MzzcOFF MzziON MzzhOFF MzzhON MzzbON MzzcON MzazON MzzhOFF MzazOFF MzazON MzziOFF MzzbOFF MzazOFF MzzkOFF MzzkON MzzhON MzzhOFF MzzcOFF MzzgON MzzcON MzzkOFF MzzeON MzzgOFF MzzcOFF MzzcON MzzeOFF MzzcOFF MzzkON MzzcON MzzkON MzzcOFF MzzcON MzzkOFF MzzeON MzzkON MzzcOFF MzzeOFF MzzkOFF MzzcON MzzeON MzzkON MzzgON MzazON MzzgOFF MzazOFF MzzgON MzzkOFF MzzcOFF MzzeOFF MzzcON MzzeON MzzgOFF MzzeOFF MzzcON MzzcOFF	
baxzi	MzzgON MzzeON MzzgOFF MzzeOFF
baxzk	MzzeON MzzgON MzzeOFF MzzgOFF MzzkON MzzkOFF MzzcON MzzcOFF MzzeON MzzgON MzzgOFF MzzeOFF MzazON MzzkON MzzgON MzazOFF MzzgOFF MzzkOFF MzzkON
baxaz	MzzkOFF MzazON MzaaON MzazOFF MzaaOFF MzzgON MzzeON MzzgOFF MzzeOFF MzzcON MzzeON MzzcOFF MzzcON MzzeOFF MzzeON MzzcOFF MzzeON MzzcON MzzeOFF MzzcOFF MzazON MzzgON MzazOFF MzazON MzzgOFF MzazOFF MzzcON MzzeON MzzcON MzzeOFF MzzeON MzzcOFF MzzeOFF MzazON MzzkON MzazOFF
baxaa	MzazON MzzkOFF MzazOFF MzzeON MzzeOFF MzzeON MzzeOFF MzzeON MzzeOFF MzzeON MzzeOFF MzazON MzazOFF
baxab	MzzeON MzzhON MzzeOFF MzzhOFF MzzeON MzzeON MzzeOFF MzzeON MzzeOFF MzzeON MzzeOFF MzazON MzazOFF MzzeON MzzcON MzzcOFF MzzcON MzzkON MzzcOFF MzzkOFF MzzcON MzzeOFF MzzcOFF MzzgON MzzeON MzzgOFF MzzgON MzzgOFF MzzbON MzzcON MzzeOFF MzzgON MzzbOFF MzzbON MzzgOFF
baxac	MzzgON MzzbOFF MzzbON MzzeON MzzhON MzzgOFF MzziON MzzkON MzzbOFF MzaeON MzagON MzzcOFF MzzkOFF MzzhOFF MzziOFF MzahON MzzeOFF MzaiON MzzeON MzaeOFF MzagOFF MzzkON MzzeOFF MzagON MzzgON MzzhON MzaeON MzaiOFF MzahOFF MzzgOFF MzziON MzazON MzagOFF MzzhOFF MzzhON MzzaON MzaeOFF MzzeON MzzhON MzzeOFF MzzeON MzazOFF MzzhOFF MzziOFF MzzaOFF MzzaON MzzhON MzzkOFF MzbcON MzzkON MzzhOFF MzzeOFF MzbbON MzziON MzzeON MzzaOFF MzziOFF MzzeOFF MzbcOFF MzzeON MzbaON MzzgON MzzgOFF MzzkOFF MzzeOFF MzzkON MzbaOFF MzzgON MzzgOFF MzbaON MzbbOFF MzbaOFF MzbbON MzbbOFF MzzkOFF MzzeON MzbbON MzzeON MzzkON MzbbOFF MzazON MzaaON MzbaON MzazOFF MzzkOFF MzaaOFF MzbdON MzzeOFF MzzeON MzbeON MzbgON MzbdOFF MzzeOFF MzzkON MzbaOFF MzzeON MzbeOFF MzzkOFF MzzeOFF MzzkON MzzeON MzzeOFF MzaaON MzzeON MzzkOFF MzaaOFF MzzeOFF MzzkON MzzeON MzzkOFF MzbgOFF MzzeOFF MzzeON MzzkON
baxad	MzzkOFF MzzeOFF MzzgON MzzeON MzzgOFF MzzeOFF MzzeON MzzeOFF MzzeON MzzeOFF MzzeON MzzkON MzzeOFF MzzeON MzazON MzzeOFF MzzkON MzbgON MzzkOFF MzzeON MzazOFF MzbgOFF MzzeOFF MzzeON MzzeON MzzeOFF MzzeON MzzeOFF MzbgON MzzeON MzbgOFF MzzeOFF MzzeON MzbgON MzbgOFF MzzeON MzzeOFF MzzeON MzzkON MzzeOFF MzzeON MzbgON MzzgON MzbgOFF MzzkOFF MzbgON MzzgOFF
baxae	MzbhON MzbiON MzbkON MzchON MzbgOFF MzbiOFF MzbhOFF MzzeOFF MzbkOFF MzzeON MzchOFF MzchON MzzeOFF MzchOFF MzzgON MzzkON MzzgOFF MzzeON MzzkOFF MzzgON MzzgOFF MzzeOFF MzzeON MzzeOFF MzazON MzazOFF MzzeON MzzkON MzzkOFF MzzeOFF MzzeON MzzeOFF MzzeON MzzkON MzazON MzazOFF MzzkOFF MzzeOFF
baxag	MzazON MzzkON MzzkOFF MzzkON MzazOFF MzzeON MzzkOFF MzzkON MzzgON MzzkOFF MzzeON MzzgOFF MzzgON MzzgON MzzeOFF MzzeON MzzgOFF MzzeOFF MzzgON MzazON MzzgOFF MzzeON MzzhON MzazOFF MzzgON MzzgOFF MzzgON MzzhOFF MzazON MzzkON MzzgOFF MzazOFF MzzgON MzazON MzzkOFF MzzdON MzzeOFF MzazOFF MzzcON MzzbON MzzgOFF MzzdOFF MzzhON MzzaON MzbcON MzzbOFF MzzcOFF MzzhOFF MzbcOFF MzzaOFF MzaaON MzzaON MzaaOFF MzaaON MzaaOFF MzaaON MzaaOFF MzzaOFF MzzaON MzzaON MzzaOFF
baxah	MzbcON MzzaOFF MzbcOFF MzzaON MzzaOFF MzzaON MzchON MzchOFF MzchON MzchOFF MzzaOFF MzzaON MzzaOFF MzzaON MzzhON MzzkON MzaaON MzzbON MzzgON MzzcON MzzkOFF MzzkON MzzgOFF MzzhOFF MzzhON MzzaOFF MzzdON MzaaOFF MzzbOFF MzzeON MzzkOFF MzzgON MzzdOFF MzzkON MzzcOFF MzzhOFF MzchON MzzkOFF MzzeOFF MzzgOFF MzbkON MzzeON MzbiON MzchON MzbhON
baxai	MzchOFF MzbkOFF MzbhOFF MzbgON MzbiOFF MzbeON MzbdON MzbgOFF MzbaON MzbbON MzbeOFF MzbdOFF MzbaOFF MzzaON MzbcON MzzhON MzbbOFF MzzhOFF MzbcOFF MzzaOFF MzzeOFF MzzeON MzzgON MzzhON MzzaON MzzgOFF MzzeOFF MzzhON MzziON MzzaOFF MzzhOFF MzziOFF MzzkON MzzeON MzzkOFF MzzgON MzzgOFF MzzeOFF MzzeON MzzeOFF MzzeON MzzeOFF MzzeON MzzeOFF MzzeON MzzkON
baxak	MzzhON MzziON MzzeOFF MzzhOFF MzzeON MzadON MzziOFF MzzkOFF MzadON MzzeOFF MzadOFF MzzeON MzzkON MzzkOFF MzzeOFF MzzkON MzzkON MzzkOFF MzzkOFF MzadON MzacON MzabON MzaaON MzacOFF MzadOFF MzabOFF MzazON MzzeON	
baxbz	MzazOFF MzzeOFF MzaaOFF MzzeON MzaaON MzazON MzzkON MzazOFF MzaaOFF MzzeOFF MzzeON MzzeOFF MzzkOFF MzzeON MzzeON MzzeOFF MzzeON MzzeON MzzeOFF MzaaON MzaaOFF MzaaON MzaaOFF MzzeON MzzeOFF MzzeON
baxba	MzaaON MzzeOFF MzzeON MzzeOFF MzaaOFF MzzeON MzazON MzazOFF MzzhON MzzeOFF MzzhOFF MzzeON MzzeOFF MzzeON MzzeOFF MzzeON MzaaON MzzeOFF MzaaOFF MzaaON MzzeON MzzkON MzaaOFF MzzkOFF MzzkON MzzhON MzzhOFF MzzeOFF MzzeON MzazON MzazOFF MzzkOFF MzazON
baxbb	MzazOFF MzzeOFF MzzeON MzzeOFF MzazON MzzeON MzazOFF MzzgON MzazON MzzkON MzzhON MzazOFF MzzgOFF MzzgON MzazON MzzhOFF MzzkOFF MzazOFF MzzeOFF MzzgOFF MzzgON MzzeON MzzgOFF MzzgON MzzeOFF MzaaON MzazON MzzeON MzzgOFF MzazOFF MzaaOFF MzzgON MzazON MzzgOFF MzzdON MzazON MzzeOFF MzzgON MzzcON MzzbON MzazOFF MzzkON MzzdOFF MzzhON MzziON MzzgOFF MzazON MzzcOFF MzzbOFF MzazOFF MzaeON MzagON MzzkOFF MzazON MzzhOFF MzziOFF MzahON MzazOFF MzazON MzaeOFF MzagOFF MzazOFF MzzhON MzzhOFF MzzkON MzagON MzaeON MzziON MzagOFF MzahOFF MzzhON MzaeOFF MzzgON MzzkOFF MzzkON MzzeON MzzhOFF MzziOFF MzzgOFF MzzkOFF
baxbc	MzzeOFF MzzeON MzzkON MzzeOFF MzzeON MzzeOFF MzzkOFF MzzeON MzaaON MzzeOFF MzaaOFF MzaaON MzzeON MzazON MzazOFF MzaaOFF MzzeOFF MzzkON MzzkOFF MzzeON MzzeOFF MzzeON MzzeOFF MzaaON MzaaOFF MzzeON MzzeOFF MzzeON MzzeOFF MzzkON MzzkOFF
baxbd	MzzeON MzzkON MzzeOFF MzzkOFF MzzkON MzzkOFF MzzeON MzzeOFF MzzeON MzzeOFF MzzeON MzzeOFF MzzkON MzabON MzzkOFF MzabOFF MzaaON MzabON MzabOFF MzacON MzacON MzaaOFF MzzeON MzacOFF MzzeOFF MzabON MzaaON MzabOFF MzaaOFF
baxbe	MzaaON MzaaOFF MzzeON MzzeOFF MzzeON MzzeOFF
baxbg	MzaaON MzzkON MzzkOFF MzzkON MzaaOFF MzabON MzaaON MzabOFF MzabON MzzkOFF MzabOFF MzabON MzzhON MzabOFF MzzhOFF MzaaOFF MzzeON MzzeOFF MzzeON MzzeOFF MzzeON MzzeON MzzeOFF MzzeOFF MzzeON MzzeOFF	
baxbh	MzzeON MzzeOFF MzaaON MzzeON MzzkON MzaaOFF MzzkOFF MzzeOFF MzabON MzabOFF MzabON MzabOFF MzzeON MzzeOFF MzabON MzabON MzzeON MzzeOFF MzabOFF MzaaON MzaaOFF
baxbi	MzabON MzabOFF MzabON MzaaON MzzeON MzzeOFF MzzeON MzazON MzaaOFF MzzeOFF MzaaON MzabOFF MzazOFF MzzkON MzaaOFF MzzkOFF MzzkON MzazON MzazOFF MzzeON MzzeOFF MzzkOFF MzzeON MzzeOFF MzzeON MzzeOFF MzaaON MzaaOFF MzaaON MzaaOFF MzzeON MzaaON MzzeOFF MzzeON MzaaOFF MzzeOFF MzabON MzzeON MzabOFF MzzeOFF MzzeON MzzgON 
baxbk	MzzgOFF MzzeOFF MzzeON MzzeOFF MzzeON MzzeOFF MzzeON MzzeOFF MzabON MzazON MzabOFF MzazOFF MzzeON MzzeOFF MzzeON MzabON MzzeOFF MzabOFF MzzeON MzzeOFF MzzeON MzabON MzabOFF MzaaON MzabON MzazON MzazOFF MzaaOFF MzabOFF MzabON MzzkON
baxcz	MzzkOFF MzabOFF MzzeOFF MzzeON MzzeOFF MzzeON MzzeOFF MzzeON MzabON MzabOFF MzzeOFF MzzeON MzzeOFF MzzeON MzzeOFF MzzeON MzzeOFF MzzkON MzzeON MzazON MzzeOFF MzaaON MzzeON MzabON MzzgON MzzkOFF MzzhON MzabOFF MzzkON MzzhOFF MzazOFF MzaaOFF MzazON MzzgOFF MzzgON MzzkOFF MzzeOFF MzzgOFF MzzeON MzzkON MzaaON MzzgON MzaaOFF MzzeOFF MzzeON MzazOFF MzzeOFF MzaaON MzzeON MzaaOFF MzzkOFF MzzkON MzzgOFF
baxca	MzzkOFF MzzgON MzaaON MzzeOFF MzzeON MzazON MzzeOFF MzazOFF MzaaOFF MzacON MzzgOFF MzabON MzadON MzabOFF MzzgON MzziON MzzkON MzacOFF MzzeON MzadOFF MzzkOFF MzzgOFF MzzkON MzadON MzzeOFF MzziOFF MzzkOFF MzacON MzzkON MzadOFF MzzkOFF MzaaON MzacOFF MzzkON MzzgON MzzeON MzzkOFF MzaaOFF MzzgOFF MzzeOFF MzzeON MzzgON MzzgOFF MzzeOFF MzzeON MzzeOFF MzaaON MzzeON MzaaOFF MzaaON MzzeOFF MzaaOFF
baxcb	MzzeON MzzeOFF MzaaON MzzeON MzzeOFF MzaaOFF MzzeON MzzeOFF MzzeON MzzeOFF MzzeON MzzgON MzzgOFF MzzeOFF MzaaON MzaaOFF MzazON MzazOFF MzzkON MzziON MzziOFF MzzeON MzzkOFF
baxcc	MzzkON MzzeOFF MzzgON MzzkOFF MzabON MzaaON MzzkON MzzgOFF MzabOFF MzzkOFF MzaaOFF MzzeON MzzkON MzzeOFF MzzkON MzaaON MzzkOFF MzzhON MzzhOFF MzzkON MzaaOFF MzzkOFF MzabON MzaaON MzzkON MzabOFF MzabON MzzeON MzazON MzzhON MzzhOFF MzabOFF MzaaOFF MzazOFF MzzeOFF MzzkOFF MzzeON MzzkON MzzeOFF MzzeON MzzkOFF MzzkON MzzeOFF MzzkOFF MzazON MzazOFF MzazON MzzeON MzzgON MzzkON MzzgOFF MzzeON MzzeOFF MzazOFF MzzkOFF MzzeOFF
baxcd	MzzeON MzzeOFF MzzgON MzzeON MzzkON MzzgOFF MzzgON MzazON MzzkON MzzgOFF MzzkOFF MzazOFF MzzhON MzzkON MzzeOFF MzazON MzzhOFF MzzkOFF MzzeON MzazOFF MzzeOFF MzazON MzzkON MzzeON MzazOFF MzazON MzzeOFF MzzkOFF MzazOFF MzzeON MzzeOFF MzzkON MzzeON MzzkON MzzeOFF MzzkOFF MzzeON MzzeOFF MzzeON MzzeOFF MzzeON MzazON MzzkON MzazOFF MzzkOFF MzzeOFF MzaaON MzzkON MzzeON MzzkOFF MzaaOFF MzaaON MzzkON MzzgON
baxce	MzzkOFF MzzgOFF MzzhON MzaaOFF MzaaON MzzgON MzaaOFF MzaaON MzzkON MzzhOFF MzabON MzzhON MzabOFF MzzeOFF MzzeON MzaaOFF MzzgOFF MzzhOFF MzazON MzzkOFF MzzeOFF MzazOFF MzaaON MzazON MzazOFF MzaaOFF MzzgON MzzgOFF MzaaON MzaaOFF MzaaON MzzeON MzzeOFF MzabON MzzkON MzazON MzabOFF MzazOFF MzaaON MzzkOFF MzzeON MzzgON MzaaOFF MzaaON MzzgOFF MzzeOFF MzaaOFF MzaaON MzzeON MzaaOFF
baxcg	MzzeOFF MzazON MzzkON MzazOFF MzzeON MzzkOFF MzazON MzzeOFF MzzeON MzazOFF MzaaON MzzeOFF MzaaOFF MzaaON MzazON MzaaOFF MzazOFF MzzeON MzaaON MzzeOFF MzzeON MzzeOFF MzzgON MzzeON MzaaOFF MzzgOFF MzzgON MzzgOFF MzzeOFF MzzgON MzzeON MzzgON MzzgOFF MzaaON MzzgOFF MzzeOFF MzzeON MzaaOFF MzzeOFF MzzeON MzaaON MzzeOFF MzzeON MzzeOFF MzzeON MzzeOFF MzzeON MzaaOFF MzzeOFF
baxch	MzzeON MzzeOFF MzzeON MzazON MzzgON MzazOFF MzzeOFF MzzgOFF MzaaON MzaaOFF MzaaON MzazON MzzkON MzazOFF MzzkOFF MzazON MzazOFF MzaaOFF MzaaON MzzgON MzzgOFF MzaaOFF MzaaON MzazON MzzkON MzzhON MzzgON MzzkOFF MzazOFF MzzhOFF MzaaOFF MzzeON MzzeOFF MzzeON MzaaON MzzgOFF MzzgON MzaaOFF MzzeOFF MzaaON MzzeON MzzgOFF MzzgON MzzdON MzzcON MzzeOFF MzzbON MzaaOFF MzzdOFF MzzhON MzaaON MzziON MzzcOFF  
baxci	MzzkON MzaaOFF MzzbOFF MzaeON MzagON MzzkOFF MzzhOFF MzzhON MzziOFF MzziON MzaaON MzzkON MzzgOFF MzzhOFF MzzkOFF MzziOFF MzahON MzaiON MzaiOFF MzziON MzahOFF MzaaOFF MzzhON MzaeOFF MzagOFF MzzgON MzziOFF MzahON MzzhOFF MzzeON MzzgOFF MzahOFF MzzgON MzzgOFF MzzgON MzaaON MzahON MzzeOFF MzzeON MzaaOFF MzagON MzaeON MzziON MzzeOFF MzzkON MzahOFF MzzhON MzzgOFF MzagOFF MzzgON MzaeOFF MzzkOFF MzzeON MzziOFF MzzhOFF MzzeOFF MzaaON MzaaOFF MzaaON MzaaON MzzgOFF MzzgON MzazON MzzeON
baxck	MzzkON MzzeOFF MzazON MzaaOFF MzzkOFF MzzeON MzaaON MzzgOFF MzaaOFF MzazOFF MzaaON MzzgON MzzhON MzzeOFF MzzhOFF MzazON MzazOFF MzzeON MzaaOFF MzzeOFF MzaaON MzaaOFF MzzeON MzzgOFF MzzgON MzzgOFF MzzgON MzaaON MzzeOFF MzacON MzabON MzzhON MzadON MzzeON MzzhOFF MzabOFF MzzhON MzziON MzaaOFF MzzkON MzacOFF MzzhOFF MzzhON MzzkOFF MzadOFF MzzcON MzzbON MzzgOFF MzzbOFF MzziOFF MzzeOFF MzzeON MzzgON MzzcOFF MzzgOFF MzzhOFF MzzeOFF MzzhON MzzhOFF MzzcON MzzcOFF MzzgON
baxdz	MzzcON MzzgOFF MzzcOFF MzzgON MzzhON MzzhON MzzbON MzzgOFF MzzcON MzzbOFF MzzcOFF MzzhOFF MzzhON MzzgON MzzkON MzzgOFF MzzkON MzzhOFF MzazON MzazOFF MzzkOFF MzzgON MzzgOFF MzzeON MzzgON MzazON MzzgOFF MzzkON MzzeOFF MzazOFF MzzkOFF MzzgON MzzcON MzzbON MzzeON MzzgOFF MzzbOFF MzzkON MzzeOFF MzzkON MzzcOFF MzzkOFF MzzgON MzzeON MzzcON MzzgOFF MzzcOFF
baxda	MzzkON MzzkOFF MzzeOFF MzzgON MzazON MzzeON MzzgOFF MzzgON MzazOFF MzzeOFF MzzeON MzzgOFF MzzcON MzzcOFF MzzcON MzzkON MzzgON MzzhON MzzbON MzziON MzzkON MzazON MzziOFF MzzkOFF MzzgOFF MzziON MzazOFF MzzeOFF MzzbOFF MzzeON MzzkON MzazON MzzhOFF MzzgON MzziOFF MzzeOFF MzazOFF MzzgOFF MzzeON MzzbON MzzgON MzzbOFF MzzkOFF MzzgON MzzgOFF MzzbON MzzbOFF MzzeON MzzeOFF MzzcOFF MzzeOFF MzzcON MzzgOFF MzzcOFF MzzcON MzzgON MzzcOFF MzzcON MzzcOFF MzzgOFF MzzgON MzzeON MzzgOFF MzzeOFF MzzeON MzzkON MzzeON MzzcON MzzgON
baxdb	MzzeOFF MzzgOFF MzzcOFF MzzcON MzzeON MzzgON MzzcOFF MzzeOFF MzzeON MzzkOFF MzzgOFF MzzeOFF MzzgON MzzeON MzzgOFF MzzgON MzzkON MzzkOFF MzzgOFF MzzkON MzzgON MzzkOFF MzzgOFF MzzkON MzzeOFF MzzkOFF MzzeON MzzgON MzzeOFF MzzgOFF MzzkON MzzkOFF MzzcON MzzbON MzzhON MzzgON MzzeON MzziON MzzbOFF MzaeON MzzgOFF MzzhOFF MzzcOFF MzagON MzahON MzziOFF MzagOFF MzaeOFF MzzeOFF MzzeON MzahOFF MzzeON MzahON MzzeOFF MzzkON MzzeON MzzeOFF MzagON MzahOFF MzzeON MzzkOFF MzagOFF MzagON MzzeOFF	
baxdc	MzagOFF MzazON MzzeON MzazON MzagON MzazOFF MzzkON MzaeON MzazOFF MzagOFF MzzeON MzaeOFF MzzkOFF MzziON MzzkON MzzkOFF MzziOFF MzzkON MzzkOFF MzziON MzzeOFF MzzkON MzzkOFF MzzeON MzzgON MzzeOFF MzzkON MzzgOFF MzzkON MzziOFF MzzkOFF MzzkON MzziON MzzkOFF MzzhON MzzkON MzzbON MzzeON MzzcON MzzgON MzzhOFF MzzkOFF MzzgOFF MzziOFF MzzeOFF MzzgON MzzkON MzzbOFF MzzeON MzzcOFF MzzgOFF MzzkOFF MzzgON MzzcON MzzcOFF MzzkON MzzeOFF MzzgOFF MzzcON MzzkOFF MzzkON MzzeON MzzeOFF MzzcOFF
baxdd	MzzkON MzzkOFF MzzgON MzzgOFF MzzeON MzzcON MzzeOFF MzzcOFF MzzgON MzzeON MzzeOFF MzzgOFF MzzgON MzzcON MzzeON MzzgOFF MzzcOFF MzzeOFF MzzeON MzzkON MzzgON MzzgOFF MzzgON MzzkOFF MzzcON MzzgOFF MzzeOFF MzzcOFF MzzkON MzzkOFF MzzeON MzzgON MzzcON MzzcOFF MzzgOFF MzzgON MzzeOFF MzzgOFF MzzkON  MzzeON MzzeOFF MzzkOFF MzazON MzzeON
baxde	MzzeOFF MzazOFF MzzeON MzzeOFF MzzeON MzzeOFF MzazON MzazOFF MzzgON MzzkON MzzhON MzzgON MzzhOFF MzzgOFF MzzkOFF MzzeON MzzcON MzzbON MzzeOFF MzzcOFF MzzbOFF MzzkON MzzkOFF MzzeON MzzeOFF MzzeON MzzeOFF MzzcON
baxdg	MzzeON MzzcOFF MzzeOFF MzzeON MzzkON MzazON MzzeOFF MzzkOFF MzazOFF MzazON MzzeON MzzcON MzazOFF MzzgON MzzcOFF MzzgOFF MzzeOFF MzzeON MzzeOFF MzzeON MzzeOFF MzzeON MzzeOFF MzzeON MzzeOFF MzzeON MzzeOFF MzzbON MzzcON MzzeON MzzbOFF MzzcOFF MzzbON MzzcON MzzeOFF
baxdh	MzzkON MzzbOFF MzzcOFF MzzcON MzzbON MzzkOFF MzzcOFF MzzbOFF MzzbON MzzkON MzzcON MzzbOFF MzzkOFF MzzbON MzzbON MzzcOFF MzzbOFF MzzkON MzzkOFF MzzkON MzzcON MzzgON MzzbON MzzeON MzzcOFF MzzkOFF MzzcON MzzgOFF MzzgON MzzhON MzzeOFF MzzhOFF MzzeON MzzbOFF MzzgON MzazON MzzbON MzazOFF MzzbOFF MzzeOFF MzzeON MzzgON MzazON MzzkON MzzeOFF MzzgOFF MzazOFF MzzgON MzzcOFF MzzkOFF MzzeON MzzgOFF MzzkON MzzeOFF MzzkOFF MzzgON MzzkON MzzeON MzzkOFF MzzeOFF MzzgOFF MzzeON MzzgON MzzeOFF MzzgOFF MzzgON MzzgOFF MzzgON MzzcON MzzcOFF MzzgOFF
baxdi	MzzgON MzzgOFF MzzcON MzzgON MzzkON MzzcON MzzgOFF MzzcOFF MzzgON MzzeON MzzkOFF MzzeOFF MzzeON MzzgOFF MzzeOFF MzzeON MzzeOFF MzzeON MzzeOFF MzzcON MzzbON MzzgON MzzkON MzzbOFF MzzcOFF MzzcON MzzgOFF MzzcOFF MzzeON MzzeOFF MzzkOFF MzzgON MzzcON MzzgOFF MzzcOFF MzzeON MzzkON MzzkOFF MzzeOFF
baxdk	MzzeON MzzeOFF MzzeON MzzeOFF MzzcON MzzcOFF MzzcON MzzcOFF MzzcON MzzcOFF MzzeON MzzgON MzzeOFF MzzgOFF MzzeON MzzeOFF MzzeON MzzeOFF
baxez	MzzkON MzzkOFF MzzcON MzzcOFF MzzgON MzzgOFF MzzcON MzzcOFF MzzeON MzzeOFF MzzbON MzzeON MzzbOFF MzzeOFF MzzeON MzzgON MzzeOFF MzzgON MzzgOFF MzzgOFF MzzeON MzzeOFF MzzeON MzzkON MzzeOFF MzzgON MzzkOFF MzzeON MzzeOFF MzzgOFF MzzgON
baxea	MzzgOFF MzzkON MzzgON MzzkOFF MzzcON MzzgOFF MzzcOFF MzzeON MzzeOFF MzzeON MzzeOFF MzazON MzazOFF MzzgON MzzgOFF
baxeb	MzzgON MzzgOFF MzzkON MzzkOFF MzzeON MzzeOFF MzzkON MzzeON MzzkOFF MzzeOFF MzzeON MzaaON MzzeOFF MzaaOFF MzzcON MzzcOFF MzzeON MzzeOFF MzaaON MzaaOFF MzzcON MzzgON MzzeON MzzgOFF MzzcOFF MzzeOFF MzzgON MzzkON MzazON MzzkOFF MzazOFF MzzgOFF MzzgON MzzgOFF MzzgON	
baxec	MzzgOFF MzzkON MzzhON MzzgON MzzhOFF MzzkOFF MzzkON MzzeON MzzgOFF MzzkOFF MzzeOFF MzzeON MzzeOFF MzzkON MzzeON MzzkOFF MzzkON MzzkOFF MzzeOFF MzzeON MzzeOFF	
baxed	MzzcON MzzeON MzzeOFF MzzeON MzzcOFF MzzeOFF MzzeON MzzeOFF MzzeON MzzeOFF MzazON MzazOFF MzzcON MzzgON MzzeON MzzcOFF MzzgOFF MzzeOFF MzzcON MzzeON MzzcOFF MzzeOFF MzzeON MzzeOFF MzzeON MzzeOFF MzzgON MzzkON MzzhON MzzcON MzzkOFF MzzgOFF MzzgON MzziON MzzgOFF MzzcOFF MzzkON MzaeON MzagON MzzkOFF MzzhOFF MzziOFF MzzkON MzziON MzagOFF MzzhON MzzaON MzzkOFF MzbcON MzaeOFF MzbbON MzbaON MzzhOFF MzziOFF MzbdON MzzgON MzzaOFF MzbcOFF MzbeON MzbgON MzbbOFF MzbaOFF MzbeOFF MzzgOFF MzbdOFF
baxee	MzzgON MzbhON MzzgOFF MzbgOFF MzbiON MzbkON MzchON MzbiOFF MzbhOFF MzzeON MzzeOFF MzzeON MzzeOFF MzchOFF MzbkOFF MzzeON MzzeOFF
baxeg	MzzeON MzzeOFF MzzgON MzzgOFF MzzeON MzzeOFF MzaaON MzzeON MzaaOFF MzzeOFF MzzeON MzzgON MzzgOFF MzzgON MzzgOFF MzzeOFF MzzeON MzzeOFF MzzeON MzzeOFF MzzeON MzzcON MzzeOFF MzzcOFF MzzcON MzzcOFF MzaaON MzzeON MzaaOFF MzzgON MzzgOFF	
baxeh	MzzeOFF MzzeON MzzeOFF MzzeON MzzdON MzzdOFF MzzgON MzzgOFF MzzeOFF MzzcON MzzeON MzzgON MzzgOFF MzzgON MzzcOFF MzzgOFF MzzeOFF MzzeON MzzgON MzzeOFF MzzeON MzzgOFF MzzgON MzzeOFF MzzgOFF MzazON MzzeON MzzgON MzazOFF MzzgOFF MzzcON MzchON MzzeOFF MzzeON MzzbON MzbkON MzbiON MzbhON MzbkOFF MzzeOFF MzzeON MzbgON MzbhOFF MzchOFF MzbiOFF MzbeON MzbdON MzbaON MzbbON MzbgOFF MzbcON MzbeOFF MzzaON MzzhON MzzeOFF MzzbOFF MzbaOFF MzbbOFF MzziON MzazON MzbcOFF MzzeON MzzaOFF MzzgON MzbdOFF MzzgOFF MzzbON MzziOFF MzazOFF MzzgON MzazON MzzgOFF MzziON MzzdON MzzeOFF MzziOFF MzzbOFF MzzgON MzzeON MzzaON MzazOFF MzzgOFF MzzdOFF MzzbON MzzaOFF MzziON MzzgON MzzbOFF MzzgOFF
baxei	MzziOFF MzzeOFF MzzhOFF MzzhON MzzcOFF MzzeON MzzgON MzzcON MzzhOFF MzzcOFF MzzgOFF MzzhON MzzeOFF MzzgON MzzeON MzzeOFF MzziON MzzeON MzzcON MzzeOFF MzzgOFF MzzgON MzzgOFF MzzgON MzziOFF MzzkON MzzhOFF MzzgOFF MzzcOFF MzzkOFF MzzcON MzzcOFF MzzcON MzzeON MzzeOFF MzzcOFF MzzkON MzzkOFF MzzeON MzzgON MzzeOFF MzzgOFF MzzeON
baxek	MzzeOFF MzzeON MzzeOFF MzzeON MzzeOFF MzzgON MzzgOFF MzzgON MzzgOFF MzzcON MzzbON MzzcOFF MzzbOFF MzzeON MzzeOFF MzzeON MzzeOFF MzzeON MzzeON MzzeOFF 
bbxzz	MzaaON MzaaOFF MzazON MzazOFF MzzgON MzzgOFF 
bbxza	MzzcON MzzcOFF
bbxzb	MzzkON MzzkOFF MzzeON MzazON MzazOFF MzzeOFF
bbxzc	MzazON MzazOFF MzzcON MzzgON MzzcON MzzcOFF MzzcOFF MzzgOFF MzzcON MzzcOFF MzzcON MzzcOFF MzzcON MzzeON MzzeOFF MzzcOFF MzzeON MzzeOFF MzzeON MzazON MzzeOFF MzazOFF MzzeON MzzeON MzzeOFF MzzeOFF MzzeON MzzeOFF MzzcON
bbxzd	MzzeON MzzcOFF MzazON MzazOFF MzzeOFF MzzeON MzzeOFF MzzeON MzzeOFF MzzeON MzzeOFF MzzeON MzzeOFF MzzeON MzzeOFF MzzeON MzzeOFF MzzdON MzzdOFF MzzdON MzzdOFF MzzdON	
bbxze	MzzdON MzzdOFF MzzeON MzzdON MzzeOFF MzzeON MzzeOFF MzzeON MzzdOFF MzzeOFF MzzeON MzzdON MzzeOFF MzzdOFF MzzeON MzzdON MzzdOFF MzzeOFF MzzgON MzzgOFF MzzeON MzzeOFF MzzgON MzzgOFF MzzcON MzzcOFF MzzcON MzzeON MzzdON MzzeOFF MzzcOFF MzzdOFF MzzdON MzzdOFF MzzeON MzzeOFF MzzdON MzzeON MzzeOFF MzzkON
bbxzg	MzzkOFF MzzeON MzzdOFF MzzeOFF MzzeON MzzcON MzzkON MzzcOFF MzzcON MzzeOFF MzzeON MzzkOFF MzzkON MzzbON MzzdON MzzdOFF MzzbOFF MzzeOFF MzzdON MzzkOFF MzzdON MzzcOFF MzzdOFF MzzkON MzzkOFF MzzkON MzzcON MzzeON MzzcOFF MzzeOFF MzzkOFF MzzdON MzzdOFF
bbxzh	MzzeON MzzdON MzzdOFF MzzgON MzzeOFF MzzgOFF MzzdON MzzeON MzzeOFF MzzdOFF MzzeON MzzeOFF MzzeON MzzeOFF MzzgON MzzeON MzzdON MzzgOFF MzzgON MzzdOFF MzzgOFF MzzgON MzzgOFF MzzgON MzzgOFF MzzgON MzzgOFF MzzeOFF MzazON MzazOFF MzzeON
bbxzi	MzzeON MzzeOFF MzazON MzzeON MzazOFF MzzgON MzzgOFF MzzeOFF MzzeON MzzgON MzzgOFF MzzgON MzzeOFF MzzgOFF MzzcON MzzgON MzzgOFF MzzgON MzzeON MzzcON MzzeOFF MzzeON MzzcOFF MzzgOFF MzazON MzzeOFF MzazOFF MzzeON MzzkON MzzkOFF MzzgON MzzgOFF MzzcON MzzeOFF MzzeON MzzkON MzzeOFF MzzcOFF MzzeON MzzgON MzzcON MzzbON
bbxzk	MzzeOFF MzzgOFF MzzeON MzzbOFF MzzcOFF MzzeON MzzkOFF MzzkON MzzeOFF MzzgON MzzeON MzzkOFF MzzeOFF MzzeON MzzgOFF MzzeOFF MzzkON MzzkOFF MzzcON MzzeON MzzkON MzzgON MzzeOFF MzzcOFF MzzeON MzzgOFF MzzcON MzzcOFF MzzcON MzzkOFF MzzeOFF MzzbON MzzkON MzzeON MzzgON MzzkON MzzkOFF MzzeOFF MzzgOFF MzzbOFF MzzeON MzzeON MzzbON MzzcOFF MzzcON MzzbOFF MzzeOFF MzzcOFF MzzcON MzzbON MzzeON MzzbOFF MzzgON MzzgOFF MzzcOFF MzzeOFF MzzeON MzzeOFF MzzeON
bbxaz	MzzeOFF MzzkON MzzeON MzzgON MzzcON MzzgOFF MzzkOFF MzzeOFF MzzeON MzzeOFF MzzcOFF MzzeON MzzcON MzzgON MzzcOFF MzzkON MzzgOFF MzzeOFF MzzkOFF MzzeON MzzdON MzzdOFF MzzgON MzzgOFF MzzeOFF MzzeON MzzgON MzzhON MzziON MzzeOFF MzzkON MzzgOFF MzaeON MzzhOFF MzzgON MzzkOFF MzagON MzziOFF MzahON MzzgOFF MzaeOFF MzahOFF MzagOFF MzagON MzagOFF MzahON MzagON MzahOFF MzahON MzagOFF MzahOFF
bbxaa	MzzcON MzahON MzagON MzahOFF MzaeON MzadON MzzcOFF MzzcON MzagOFF MzagON MzzcOFF MzahON MzzhON MzadOFF MzzcON MzzkON MzaeOFF MzzhOFF MzaiON MzzgON MzagOFF MzzcOFF MzzkON MzzgOFF MzahOFF MzzcON MzzkOFF MzzcOFF MzzcON MzzcON MzzgON MzaiOFF MzaiON MzzcOFF MzzgOFF MzaiON MzaiOFF MzaiON MzahON MzzkON MzzgON MzagON MzaeON MzaiOFF MzzcON MzzkON MzahOFF MzziON MzzcOFF MzzgOFF MzagOFF MzzhON MzzkOFF MzaeOFF MzzgON MzzhOFF MzziOFF MzzeON MzzgOFF
bbxab	MzzeOFF MzazON MzzeON MzzgON MzazOFF MzzgOFF MzzeOFF MzzcON MzzgON MzzcOFF MzzgOFF MzzcON MzzcOFF MzzgON MzzeON MzzgOFF MzzeOFF MzzeON MzazON MzazOFF MzazON MzzeOFF MzzgON MzazOFF MzzeON MzazON MzzcON MzzgOFF	
bbxac	MzazOFF MzzcOFF MzzgON MzzgOFF MzzcON MzzbON MzzgON MzzkON MzazON MzzeOFF MzazOFF MzzeON MzzhON MzazON MzzkOFF MzziON MzzeOFF MzzeON MzzkON MzazOFF MzzbOFF MzzgOFF MzzcOFF MzzkOFF MzazON MzzkON MzzhOFF MzzeOFF MzzeON MzaeON MzazOFF MzzgON MzzhON MzzeOFF MzaeOFF MzzgOFF MzzeON MzzkOFF MzazON MzziOFF MzzcON MzzkON MzzbON MzazOFF MzzhOFF MzzbOFF MzzkOFF MzzeOFF MzazON MzzeON MzazOFF MzzcOFF MzzgON MzzeOFF MzzeON MzzgON MzzgOFF MzzkON MzzgOFF MzzeOFF MzzkOFF MzzcON MzzkON MzzkOFF MzzcOFF MzzkON MzzeON MzzkOFF MzzhON MzzkON MzzeOFF
bbxad	MzzkOFF MzzhOFF MzzeON MzzeOFF MzzhON MzzhOFF MzzgON MzzgOFF MzzhON MzzhOFF MzzhON MzzhOFF MzzeON MzzeOFF MzzeON MzzeOFF MzzeON MzzcON MzzeON MzzeOFF MzzcOFF MzzcON MzzbON MzzeOFF MzzbOFF MzzcOFF MzzeON MzzcON MzzgON MzzeOFF MzzeON MzzcOFF MzzeOFF MzzgOFF MzzcON MzzbON MzzbOFF MzzbON MzzbOFF MzzcOFF
bbxae	MzzgON MzzeON MzzgOFF MzzgON MzzeOFF MzzgOFF MzzcON MzzcOFF MzzeON MzzeOFF MzzcON MzzbON MzzeON MzzeOFF	
bbxag	MzzeON MzzkON MzzhON MzzbOFF MzzgON MzzhOFF MzzcOFF MzzgOFF MzzkOFF MzzeOFF MzzgON MzzgOFF MzzgON MzzgOFF MzzcON MzzcOFFMzzeON MzzeOFF MzzgON MzzeON MzzgOFF MzzeOFF MzzcON MzzbON MzzbOFF MzzcOFFMzzeON MzzgON MzzgOFF MzzeOFF MzzcON MzzeON MzzeOFF MzzcOFF
bbxah	MzzeON MzzeOFF MzzeON MzzeOFF MzzkON MzzkOFF MzzeON MzzeOFF MzazON MzazOFF MzzeON MzzgON MzzgOFF MzzeOFF MzzcON MzzeON MzzcOFF MzzeOFF MzzcON MzzcOFF MzzhON MzzhOFF MzzhON MzzhOFF MzzeON MzzeOFF MzzgON MzzgOFF MzzeON MzzgON MzzgOFF MzzeOFF
bbxai	MzzcON MzzcOFF MzzgON MzzcON MzzcOFF MzzcON MzzgOFF MzzeON MzzcOFF MzzcON MzzgON MzzcOFF MzzeOFF MzzeON MzzgOFF MzzgON MzzgOFF MzzcON MzzeOFF MzzcOFF MzzcON MzzcOFF MzzcON MzzcOFF MzzeON MzzeOFF
bbxak	MzzeON MzzeOFF MzzhON MzzgON MzzhOFF MzzgOFF MzzeON MzzcON MzzgON MzzcOFF 
bbxbz	MzzgOFF MzzeON MzzeOFF MzzeON MzzeOFF MzzgON MzzeON MzzcON MzzgOFF MzzeOFF MzzcON MzzcOFF MzzcON MzazON MzzkON MzzgON MzazOFF MzzgOFF MzzgON MzzbON MzzgOFF MzzcOFF MzzbOFF MzzgON MzzcON MzzeON MzzkOFF MzzcOFF
bbxba	MzzkON MzzgOFF MzzeOFF MzzhON MzzgON MzzhOFF MzzgOFF MzzgON MzzkOFF MzzgOFF MzzkON MzzhON MzzgON MzzkOFF MzzgOFF MzzhOFF MzzeON MzzgON MzzgOFF MzzeOFF MzzcON MzzcOFF MzzeON MzzcON MzzkON MzzcOFF MzzcON MzzkOFF MzzkON MzzkOFF MzzeOFF MzzkON MzzcOFF MzzkOFF
bbxbb	MzzcON MzzcOFF MzzcON MzzcOFF MzzeON MzzeOFF MzzcON MzzcOFF MzzcON MzzcOFF MzzcON MzzcOFF MzzeON MzzcON MzzeOFF MzzcOFF MzzkON MzzhON MzzgON MzzcON MzzhOFF MzzkOFF MzzcOFF MzzgOFF MzzeON
bbxbc	MzzeOFF MzzeON MzzcON MzzcON MzzcOFF MzzeOFF MzzcOFF MzzeON MzzcON MzzeOFF MzzcOFF MzzeON MzzcON MzzeOFF MzzcOFF MzzeON MzzeOFF MzzeON MzzeOFF MzzeON MzzkON MzzcON MzzcOFF MzzkOFF MzzeOFF MzzcON MzzcOFF
bbxbd	MzzcON MzzcOFF MzzcON MzzcOFF MzzkON MzzcON MzzcOFF MzzkOFF MzzgON MzzeON MzzgOFF MzzeOFF MzazON MzazOFF MzzcON MzzkON MzzgON MzzhON MzzcOFF MzzhOFF MzzcON MzzhON MzzkOFF MzzeON MzzeOFF MzzhOFF MzzeON MzzcOFF MzzeOFF MzzgOFF MzazON MzzeON MzazOFF MzazON MzazOFF MzzeOFF
bbxbe	MzzeON MzzeOFF MzzgON MzzcON MzzeON MzzeOFF MzzgOFF MzzcOFF MzzcON MzzcOFF MzzgON MzzeON MzzeOFF MzzeON MzzgOFF MzzeOFF MzzgON MzzeON MzzgOFF MzzeOFF MzzeON MzzgON MzzgON MzzgOFF MzzeOFF MzzgON MzzcON	
bbxbg	MzzgOFF MzzcOFF MzzcON MzzcOFF MzzgON MzzgOFF MzzgON  MzzgOFF MzzeON MzzgON MzzeOFF MzzgOFF MzzeON MzzgON MzzgOFF MzzeOFF MzzeON MzzeOFF MzzgON	
bbxbh	MzzgOFF MzzcON MzzcOFF MzzgON MzzgOFF MzzgON MzzgOFF
bbxbi	MzzgON MzzgOFF MzzgON MzzgON MzzgOFF MzzgOFF MzzgON MzzgOFF MzzbON MzzeON MzzeOFF MzzbOFF MzzcON MzzcOFF MzzcON MzzgON MzzcOFF MzzcON MzzcOFF MzzgOFF MzzgON MzzgOFF MzzgON	
bbxbk	MzzgOFF MzzeON MzzeOFF MzzgON MzzcON MzzgOFF MzzgON MzzcON MzzgOFF MzzgON MzzcOFF MzzgOFF MzazON MzazOFF MzzgON MzazON
bbxcz	MzzgOFF MzzgON MzazOFF MzazON MzzkON MzzhON MzziON MzazOFF MzbcON MzzaON MzzkOFF MzbbON MzbaON MzzaOFF MzziOFF MzzhOFF MzzgOFF MzbdON MzbcOFF MzbeON MzbgON MzbbOFF MzbaOFF MzbdOFF MzbeOFF MzbhON MzbgOFF MzbiON MzzgON MzbkON MzchON MzzgOFF MzbiOFF MzbhOFF MzzgON MzbkOFF MzzgOFF MzchOFF
bbxca	MzzeON MzzgON MzzkON MzazON MzazOFF MzazON MzzkOFF MzzeOFF MzazOFF MzzcON MzzbON MzzeON MzzgOFF MzzeOFF MzzcOFF MzzbOFF MzzgON MzzgOFF MzzbON MzzcON MzzgON MzchON MzzcOFF MzzgON MzzeON MzbkON	
bbxcb	MzbiON MzzgOFF MzchOFF MzbhON MzzcON MzzgON MzbkOFF MzbiOFF MzbhOFF MzbgON MzzbOFF MzbeON MzbgOFF MzzcOFF MzzcON MzbdON MzbaON MzzeOFF MzbeOFF MzbbON MzbdOFF MzzeON MzbcON MzzaON MzbaOFF MzbbOFF MzziON MzzcOFF MzzhON MzziOFF MzziON MzzcON MzbcOFF MzzaOFF MzzeOFF MzzcON MzziOFF MzzhOFF MzzeON MzzkON MzzcOFF MzzeOFF MzzkOFF MzzgOFF MzzeON MzzeOFF MzzeON MzzgON MzzgOFF MzzkON MzzgON MzzkOFF MzzgOFF MzzeOFF MzzgON MzzgOFF MzzgON MzzkON MzzeON MzzcON MzzgOFF MzzgON MzzeOFF MzzkOFF MzzcOFF MzzgOFF MzzgON MzzgOFF MzzgON MzzeON MzzgOFF MzzgON MzzeOFF
bbxcc	MzzcON MzzkON MzzcOFF MzzcON MzzgOFF MzzkOFF MzzgON MzzcOFF MzzgOFF MzzeON MzzeOFF MzzcON MzzeON MzzcOFF MzzeOFF MzzgON MzzgOFF MzzcON MzzgON MzzcOFF MzzgOFF MzzeON MzzeOFF MzzgON MzzgON MzzgOFF MzzgON MzzeON MzzeOFF MzzeON MzzgOFF MzzgON MzzhON MzzhOFF MzzhON MzzeOFF MzzgOFF MzzgON MzziON MzzkON MzazON MzzkOFF MzziOFF MzzgOFF MzazOFF MzziON MzzkON MzzhOFF MzaeON MzagON MzziOFF MzzkOFF MzahON
bbxcd	MzaeOFF MzagOFF MzahOFF MzzgON MzzcON MzzcOFF MzzcON MzzgOFF MzahON MzzcOFF MzzgON MzzgOFF MzahOFF MzahON MzzgON MzzeON MzahOFF MzazON MzaaON MzzeOFF MzaaOFF MzahON MzzgOFF MzazOFF MzaaON MzaaOFF MzaaON MzaaOFF MzaaON MzahOFF MzahON MzazON MzazOFF MzagON MzaeON MzaaOFF MzziON MzzcON MzagOFF MzzkON MzzhON MzzkOFF MzzbON MzaeOFF MzahOFF MzzcOFF MzziOFF MzziON MzzgON MzzkON MzzbOFF MzaeON MzagON MzzhOFF MzzkOFF MzziOFF MzahON MzahOFF MzaeOFF MzagOFF MzahON
bbxce	MzzgON MzzgON MzahON MzzgON MzahOFF MzahON MzagON MzaeON MzzgOFF MzahOFF MzzgON MzagOFF MzaeOFF MzzgOFF MzzgON MzaeON MzagON MzzgOFF MzzkON MzziON MzzgON MzzhON MzaeOFF MzzbON MzzkOFF MzagOFF MzzcON MzzhOFF MzzbOFF MzziOFF MzzeON MzzcOFF MzaaON MzaaOFF MzzeOFF MzaaON MzzgOFF MzzgON MzaaON MzzgOFF MzaaOFF MzzgON MzzgOFF MzzgON MzzgOFF MzzgON
bbxcg	MzzeON MzzeOFF MzazON MzazOFF MzzgOFF MzazON MzazOFF MzazON MzzkON MzazOFF MzzkOFF MzzkON MzzkOFF MzazON MzazOFF MzazON MzazOFF MzazON MzazOFF MzazON MzazOFF MzzeON MzzkON MzazON MzzhON MzzgON MzziON MzazON MzzeOFF MzzgOFF MzzkOFF MzazOFF MzzgON MzzeON MzziOFF MzzgON MzzhOFF MzazON MzzgOFF MzzkON MzzgON MzzgOFF MzzgON MzazOFF MzzkOFF MzaaON MzzgOFF MzaaOFF MzazON MzzeOFF
bbxch	MzazOFF MzzkON MzazON MzzkOFF MzazOFF MzazON MzaaON MzaaOFF MzazOFF MzazON MzzkON MzzkOFF MzaaON MzzkON MzaaOFF MzzkOFF MzazOFF MzazON MzazOFF MzzhON MzzgON MzazON MzzhOFF MzzgOFF MzzgON MzazOFF MzzgOFF MzzgON MzzgOFF MzzeON MzzgON
bbxci	MzzgOFF MzzeOFF MzzkON MzzkOFF MzazON MzazOFF MzazON MzazOFF MzzkON MzazON MzzkOFF MzazOFF MzzkON MzzeON MzzkOFF	
bbxck	MzzeOFF MzzgON MzzgOFF MzzgON MzzgOFF MzzkON MzzgON MzzkOFF MzzgOFF MzaaON MzaaOFF MzzgON MzzgOFF MzzgON MzzgOFF MzzgON MzzgOFF MzzkON MzzkOFF MzzgON MzzgOFF
bbxdz	MzzgON MzzgOFF MzzgON MzzgOFF MzzgON MzazON MzzgOFF MzzgON MzzeON MzzgOFF MzzeOFF MzazON MzazOFF MzazON MzazOFF MzazON MzazOFF MzazON MzzeON MzzkON MzzkOFF MzzkON MzzgON MzzeOFF MzzkOFF
bbxda	MzzgOFF MzzkON MzzeON MzzeOFF MzzkOFF MzazOFF MzazON MzazOFF MzazON MzzhON MzazOFF MzazON MzzhOFF MzazOFF MzazON MzazOFF MzazON MzazOFF MzazON MzazOFF MzaaON MzaaON MzaaOFF MzazON MzazOFF	
bbxdb	MzzeON MzzeOFF MzazON MzaaON MzazON MzaaON MzzeON MzazON MzzeOFF MzaaOFF MzazOFF MzazON MzzeON MzaaON MzazOFF MzazON MzzgON MzaaOFF MzzgOFF MzzeOFF MzazOFF MzzeON MzzeOFF MzazON MzzgON MzaaON MzazOFF MzaaOFF MzzgON MzaaON MzzeON MzzgON MzazON MzazOFF MzaaOFF MzaaON MzaaOFF MzzgON MzzgOFF MzzeOFF MzazON MzazOFF MzazON MzazOFF MzzeON MzzeOFF MzzeON MzzeOFF
bbxdc	MzzeON MzzeOFF MzzeON MzazON MzazOFF MzzeOFF MzazON MzazOFF MzazON MzzgON MzazOFF MzzgOFF MzzeON	
bbxdd	MzzeOFF MzzeON MzzeOFF MzzeON MzzgON MzzgON MzzeOFF MzzgOFF MzzeON MzzgON MzzgOFF MzzdON MzzeOFF MzzdOFF MzzdON MzzdOFF MzzeON MzzeOFF MzzeON MzzeOFF	
bbxde	MzzgON MzzgOFF MzzeON MzzeOFF MzzeON MzzeOFF MzazON MzzeON MzzeOFF MzazOFF MzzeON MzazON MzzeOFF MzzeON MzzeOFF MzazOFF MzzgON MzazON MzzgOFF MzazON MzzgON MzazOFF MzazON MzzeON MzzgOFF MzzgON MzazOFF MzzgOFF MzzeOFF MzazON MzzeON MzzgON
bbxdg	MzzgON MzzgOFF MzzeOFF MzazOFF MzzeON MzzgOFF MzzgON MzaaON MzzeOFF MzzgOFF MzaaOFF MzaaON MzaaOFF MzazON MzzgON MzzeON MzzgOFF MzzeOFF MzazOFF MzzgON MzzgOFF MzazON MzazOFF MzzgON MzzgOFF MzzeON MzzeOFF MzzgON MzzgOFF MzzkON MzzeON MzzkOFF MzzeOFF MzazON MzazOFF MzzeON
bbxdh	MzzgON MzzeON MzzeOFF MzzgOFF MzzgON MzazON MzazOFF MzzgOFF MzazON MzazOFF MzzeON MzzeOFF MzzgON MzazON MzazOFF MzzgOFF MzazON MzazOFF MzazON MzazOFF MzazON MzzeON MzazOFF MzazON	
bbxdi	MzzeOFF MzzeON MzzeOFF MzazOFF MzzeON MzzeON MzzeOFF MzzeON MzzgON MzzgOFF MzzeOFF MzazON MzzeON MzzgON MzazOFF MzazON MzzgOFF MzazOFF MzzeOFF MzazON MzazOFF MzzeON MzzeOFF MzazON MzazOFF MzazON MzzgON MzzgON MzzgOFF MzazOFF MzazON MzzgON MzzgOFF MzzgON MzzeON MzazON MzzeOFF MzzeON 
bbxdk	MzzgON MzzgOFF MzzeOFF MzzgON MzzgOFF MzazOFF MzazON MzzeON MzaaON MzaaOFF MzzeOFF MzaaON MzzeON MzaaOFF MzaaON MzazOFF MzazON MzzgON MzzgOFF MzaaOFF MzzeOFF MzzeON MzaaON MzzgON MzazOFF MzzeON MzazON MzzeOFF MzaaOFF MzazOFF MzzgOFF MzzeOFF MzazON MzzeON MzzgON MzaaON MzzgOFF MzazOFF MzzeOFF MzaaOFF MzzeON MzazON MzzeOFF MzazOFF MzzeON MzzeOFF MzzeON MzzeOFF MzzeON
bbxez	MzzeOFF MzzeON MzzeON MzzeOFF MzzeON MzzeOFF MzzeON MzzgON MzaaON MzzgOFF MzzgON MzazON MzaaON MzaaOFF MzzgOFF MzazOFF MzazON MzzgON MzazOFF MzzgOFF MzzeOFF MzzeON MzazON MzzgON MzzkON MzzkOFF MzazOFF MzzhON MzazON MzzkON MzzhOFF MzzhON MzaaON MzzhOFF MzazOFF MzzeOFF MzaaOFF MzzeON MzzkOFF MzzgOFF MzazON MzzgON MzazOFF MzazON MzzkON MzzhON MzzkOFF MzzgOFF MzzkON MzzeOFF MzzgON
bbxea	MzzkOFF MzzgOFF MzazOFF MzzhON MzzhOFF MzzhOFF MzzeON MzzgON MzaaON MzazON MzaaOFF MzzgOFF MzzgON MzazOFF MzaaON MzazON MzazOFF MzzeOFF MzaaOFF MzzgOFF MzaaON MzaaOFF MzaaON MzazON MzzkON MzaaOFF MzazOFF MzzeON MzzgON MzaaON MzzkOFF MzzgOFF MzaaON MzaaOFF MzzeOFF MzzkON MzzeON MzzeOFF MzazON MzzkOFF MzzeON MzaaON MzazOFF MzazON MzzeOFF MzaaOFF MzazOFF MzazON	
bbxeb	MzazOFF MzzeON MzzeOFF MzzeON MzazON MzzeOFF MzzeON MzzgON MzazON MzzeOFF MzzgOFF MzazOFF MzzeON MzaaON MzazON MzaaOFF MzzkON MzzgON MzzkOFF MzaaON MzazOFF MzzgON MzzgOFF MzzeOFF MzaaOFF MzzgOFF MzzeON MzzeOFF MzzeON MzzeOFF MzzkON MzzkOFF MzaaON MzaaOFF MzzgON MzzeON MzzeOFF MzzeON MzzeOFF MzzeON
bbxec	MzzgOFF MzzeOFF MzaaON MzaaOFF MzzeON MzzeOFF MzzeON MzzgON MzzgOFF MzzgON MzzgOFF MzzgON MzzgOFF MzzgON MzaaON MzazON MzaaON MzaaOFF MzazOFF MzzgOFF MzzgON MzazON MzzgOFF MzzeOFF MzazOFF MzaaON MzaaOFF MzzeON
bbxed	MzzeOFF MzzeON MzzgON MzzeOFF MzzeON MzzgOFF MzzeOFF MzzeON MzzgON MzzgOFF MzzeOFF MzaaON MzzeON MzzgON MzaaOFF MzaaON MzaaOFF MzzkON MzzeOFF MzzeON MzzkOFF MzzeOFF MzzkON  MzzeON MzzeOFF MzzeON MzzkOFF MzzkON MzzeOFF MzzkOFF MzzeON MzzkON MzzeOFF MzzkOFF MzzeON MzzgOFF MzzgON MzazON MzzgOFF MzazON MzzgON MzzkON MzazOFF MzazON MzzkOFF MzzgOFF MzazOFF MzzeOFF MzzeON MzzeOFF MzazON
bbxee	MzazOFF MzazON MzazOFF MzzeON MzzgON MzazON MzzkON MzzeOFF MzzkOFF MzzkON MzazOFF MzzkOFF MzzgOFF MzzgON MzzeON MzzeOFF MzzeON MzzgOFF MzzgON MzzgOFF MzzeOFF MzazON MzazOFF MzzeON MzzgON MzzeOFF MzzeON MzzgOFF MzzgON MzzeOFF MzzgOFF MzzkON MzzkOFF MzzkON MzzkOFF MzzkON MzzkOFF MzazON MzzgON MzzgOFF MzazOFF
bbxeg	MzzgON MzazON MzzgOFF MzzeON MzaaON MzzkON MzazOFF MzaaOFF MzzeOFF MzzkOFF MzzkON MzzkOFF MzzeON MzzgON MzzeOFF MzzgOFF MzaaON MzaaOFF MzzgON MzzgOFF MzaaON MzzgON MzzeON MzaaOFF MzzeOFF MzzgOFF MzzgON MzzeON MzzkON MzazON MzazOFF MzzkOFF MzzkON MzzkOFF MzzeOFF
bbxeh	MzzeON MzzeOFF MzzeON MzzgOFF MzzeOFF MzzeON MzzeOFF MzzeON MzzgON MzzeOFF MzzeON MzzeOFF MzzgOFF MzzeON MzaaON MzaaOFF MzzeOFF MzzgON MzzeON MzzeOFF MzzkON MzzeON MzzgOFF MzzkOFF MzzeOFF MzzkON MzzeON MzzkOFF MzzeOFF MzzeON MzzkON MzzkOFF MzaaON MzaaOFF MzzkON MzzeOFF MzzkOFF MzaaON MzaaOFF MzzkON MzzeON	
bbxei	MzazON MzzgON MzzkOFF MzzeON MzzgOFF MzaaON MzzgON MzazOFF MzaaOFF MzazON MzzkON MzzkOFF MzzeOFF MzazOFF MzzeON MzzgOFF MzzeOFF MzzeON MzzeOFF MzazON MzazOFF MzzeON MzzgON MzazON MzzeOFF MzazOFF MzazON MzzgOFF MzazOFF MzazON MzazOFF MzaaON MzazON MzazOFF MzaaOFF	
bbxek	MzzeON MzzeOFF MzzgON MzzeON MzzgOFF MzzgON MzzeOFF MzzeON MzzeOFF MzzgON MzzeON MzzeOFF MzzgON MzzgOFF MzazON MzazOFF MzzeON MzzeOFF MzzeON MzzeOFF MzaaON MzazON MzaaOFF MzazOFF MzaaON

